PokerStars Hand #164794615351:  Hold'em No Limit ($0.01/$0.02 USD) - 2017/01/18 16:01:54 ET
Table 'Dollfus II' 6-max Seat #5 is the button
Seat 1: pedroabreu1 ($2 in chips) 
Seat 4: Alfi_lg7 ($2.11 in chips) 
Seat 5: fkf87 ($2.76 in chips) 
Seat 6: Siim154 ($2.22 in chips) 
Siim154: posts small blind $0.01
pedroabreu1: posts big blind $0.02
*** HOLE CARDS ***
Dealt to pedroabreu1 [8s 5d]
Alfi_lg7: folds 
fkf87: raises $0.02 to $0.04
Siim154: folds 
pedroabreu1: folds 
Uncalled bet ($0.02) returned to fkf87
fkf87 collected $0.05 from pot
fkf87: doesn't show hand 
*** SUMMARY ***
Total pot $0.05 | Rake $0 
Seat 1: pedroabreu1 (big blind) folded before Flop
Seat 4: Alfi_lg7 folded before Flop (didn't bet)
Seat 5: fkf87 (button) collected ($0.05)
Seat 6: Siim154 (small blind) folded before Flop



PokerStars Hand #164794632854:  Hold'em No Limit ($0.01/$0.02 USD) - 2017/01/18 16:02:12 ET
Table 'Dollfus II' 6-max Seat #6 is the button
Seat 1: pedroabreu1 ($1.98 in chips) 
Seat 4: Alfi_lg7 ($2.11 in chips) 
Seat 5: fkf87 ($2.79 in chips) 
Seat 6: Siim154 ($2.21 in chips) 
pedroabreu1: posts small blind $0.01
Alfi_lg7: posts big blind $0.02
*** HOLE CARDS ***
Dealt to pedroabreu1 [2c 9h]
fkf87: folds 
Siim154: raises $0.04 to $0.06
pedroabreu1: folds 
Alfi_lg7: folds 
Uncalled bet ($0.04) returned to Siim154
Siim154 collected $0.05 from pot
Siim154: doesn't show hand 
*** SUMMARY ***
Total pot $0.05 | Rake $0 
Seat 1: pedroabreu1 (small blind) folded before Flop
Seat 4: Alfi_lg7 (big blind) folded before Flop
Seat 5: fkf87 folded before Flop (didn't bet)
Seat 6: Siim154 (button) collected ($0.05)



PokerStars Hand #164794648716:  Hold'em No Limit ($0.01/$0.02 USD) - 2017/01/18 16:02:28 ET
Table 'Dollfus II' 6-max Seat #1 is the button
Seat 1: pedroabreu1 ($1.97 in chips) 
Seat 4: Alfi_lg7 ($2.09 in chips) 
Seat 5: fkf87 ($2.79 in chips) 
Seat 6: Siim154 ($2.24 in chips) 
Alfi_lg7: posts small blind $0.01
fkf87: posts big blind $0.02
*** HOLE CARDS ***
Dealt to pedroabreu1 [3s Qd]
Siim154: folds 
pedroabreu1: folds 
Alfi_lg7: folds 
Uncalled bet ($0.01) returned to fkf87
fkf87 collected $0.02 from pot
fkf87: doesn't show hand 
*** SUMMARY ***
Total pot $0.02 | Rake $0 
Seat 1: pedroabreu1 (button) folded before Flop (didn't bet)
Seat 4: Alfi_lg7 (small blind) folded before Flop
Seat 5: fkf87 (big blind) collected ($0.02)
Seat 6: Siim154 folded before Flop (didn't bet)



PokerStars Hand #164794667196:  Hold'em No Limit ($0.01/$0.02 USD) - 2017/01/18 16:02:45 ET
Table 'Dollfus II' 6-max Seat #4 is the button
Seat 1: pedroabreu1 ($1.97 in chips) 
Seat 4: Alfi_lg7 ($2.08 in chips) 
Seat 5: fkf87 ($2.80 in chips) 
Seat 6: Siim154 ($2.24 in chips) 
fkf87: posts small blind $0.01
Siim154: posts big blind $0.02
*** HOLE CARDS ***
Dealt to pedroabreu1 [9s Jh]
pedroabreu1: folds 
Alfi_lg7: folds 
fkf87: raises $0.02 to $0.04
Siim154: calls $0.02
*** FLOP *** [Jc 3s 8s]
fkf87: bets $0.04
Siim154: raises $0.08 to $0.12
fkf87: calls $0.08
*** TURN *** [Jc 3s 8s] [6c]
fkf87: bets $0.14
Siim154: folds 
Uncalled bet ($0.14) returned to fkf87
fkf87 collected $0.31 from pot
fkf87: doesn't show hand 
*** SUMMARY ***
Total pot $0.32 | Rake $0.01 
Board [Jc 3s 8s 6c]
Seat 1: pedroabreu1 folded before Flop (didn't bet)
Seat 4: Alfi_lg7 (button) folded before Flop (didn't bet)
Seat 5: fkf87 (small blind) collected ($0.31)
Seat 6: Siim154 (big blind) folded on the Turn



PokerStars Hand #164794701234:  Hold'em No Limit ($0.01/$0.02 USD) - 2017/01/18 16:03:19 ET
Table 'Dollfus II' 6-max Seat #5 is the button
Seat 1: pedroabreu1 ($1.97 in chips) 
Seat 4: Alfi_lg7 ($2.08 in chips) 
Seat 5: fkf87 ($2.95 in chips) 
Seat 6: Siim154 ($2.08 in chips) 
Siim154: posts small blind $0.01
pedroabreu1: posts big blind $0.02
*** HOLE CARDS ***
Dealt to pedroabreu1 [6c 7h]
Alfi_lg7: folds 
dravó leaves the table
fkf87: folds 
Siim154: folds 
Uncalled bet ($0.01) returned to pedroabreu1
pedroabreu1 collected $0.02 from pot
pedroabreu1: doesn't show hand 
*** SUMMARY ***
Total pot $0.02 | Rake $0 
Seat 1: pedroabreu1 (big blind) collected ($0.02)
Seat 4: Alfi_lg7 folded before Flop (didn't bet)
Seat 5: fkf87 (button) folded before Flop (didn't bet)
Seat 6: Siim154 (small blind) folded before Flop



PokerStars Hand #164794713046:  Hold'em No Limit ($0.01/$0.02 USD) - 2017/01/18 16:03:31 ET
Table 'Dollfus II' 6-max Seat #6 is the button
Seat 1: pedroabreu1 ($1.98 in chips) 
Seat 4: Alfi_lg7 ($2.08 in chips) 
Seat 5: fkf87 ($2.95 in chips) 
Seat 6: Siim154 ($2.07 in chips) 
pedroabreu1: posts small blind $0.01
Alfi_lg7: posts big blind $0.02
*** HOLE CARDS ***
Dealt to pedroabreu1 [Kc 6d]
fkf87: folds 
Siim154: raises $0.04 to $0.06
pedroabreu1: folds 
Alfi_lg7: folds 
Uncalled bet ($0.04) returned to Siim154
Siim154 collected $0.05 from pot
Siim154: doesn't show hand 
*** SUMMARY ***
Total pot $0.05 | Rake $0 
Seat 1: pedroabreu1 (small blind) folded before Flop
Seat 4: Alfi_lg7 (big blind) folded before Flop
Seat 5: fkf87 folded before Flop (didn't bet)
Seat 6: Siim154 (button) collected ($0.05)



PokerStars Hand #164794730114:  Hold'em No Limit ($0.01/$0.02 USD) - 2017/01/18 16:03:48 ET
Table 'Dollfus II' 6-max Seat #1 is the button
Seat 1: pedroabreu1 ($1.97 in chips) 
Seat 4: Alfi_lg7 ($2.06 in chips) 
Seat 5: fkf87 ($2.95 in chips) 
Seat 6: Siim154 ($2.10 in chips) 
Alfi_lg7: posts small blind $0.01
fkf87: posts big blind $0.02
*** HOLE CARDS ***
Dealt to pedroabreu1 [Qd Jc]
Siim154: folds 
bashbull joins the table at seat #3 
pedroabreu1: raises $0.04 to $0.06
Alfi_lg7: folds 
fkf87: calls $0.04
*** FLOP *** [6d 7s Qh]
fkf87: checks 
pedroabreu1: bets $0.07
fkf87: raises $0.07 to $0.14
pedroabreu1: calls $0.07
*** TURN *** [6d 7s Qh] [4h]
fkf87: bets $0.20
pedroabreu1: calls $0.20
*** RIVER *** [6d 7s Qh 4h] [Tc]
fkf87: bets $0.78
pedroabreu1: calls $0.78
*** SHOW DOWN ***
fkf87: shows [Kc 8h] (high card King)
pedroabreu1: shows [Qd Jc] (a pair of Queens)
pedroabreu1 collected $2.29 from pot
*** SUMMARY ***
Total pot $2.37 | Rake $0.08 
Board [6d 7s Qh 4h Tc]
Seat 1: pedroabreu1 (button) showed [Qd Jc] and won ($2.29) with a pair of Queens
Seat 4: Alfi_lg7 (small blind) folded before Flop
Seat 5: fkf87 (big blind) showed [Kc 8h] and lost with high card King
Seat 6: Siim154 folded before Flop (didn't bet)



PokerStars Hand #164794775690:  Hold'em No Limit ($0.01/$0.02 USD) - 2017/01/18 16:04:32 ET
Table 'Dollfus II' 6-max Seat #4 is the button
Seat 1: pedroabreu1 ($3.08 in chips) 
Seat 4: Alfi_lg7 ($2.05 in chips) 
Seat 5: fkf87 ($1.77 in chips) 
Seat 6: Siim154 ($2.10 in chips) 
fkf87: posts small blind $0.01
Siim154: posts big blind $0.02
bashbull: sits out 
*** HOLE CARDS ***
Dealt to pedroabreu1 [Ac Ad]
pedroabreu1: raises $0.04 to $0.06
Alfi_lg7: folds 
fkf87: calls $0.05
Siim154: folds 
*** FLOP *** [4c Th 9d]
fkf87: checks 
pedroabreu1: bets $0.08
fkf87: raises $0.08 to $0.16
pedroabreu1: calls $0.08
*** TURN *** [4c Th 9d] [Ah]
fkf87: checks 
pedroabreu1: checks 
*** RIVER *** [4c Th 9d Ah] [Tc]
fkf87: bets $0.78
pedroabreu1: raises $1 to $1.78
fkf87: calls $0.77 and is all-in
Uncalled bet ($0.23) returned to pedroabreu1
*** SHOW DOWN ***
pedroabreu1: shows [Ac Ad] (a full house, Aces full of Tens)
fkf87: shows [Td 9s] (a full house, Tens full of Nines)
pedroabreu1 collected $3.44 from pot
*** SUMMARY ***
Total pot $3.56 | Rake $0.12 
Board [4c Th 9d Ah Tc]
Seat 1: pedroabreu1 showed [Ac Ad] and won ($3.44) with a full house, Aces full of Tens
Seat 4: Alfi_lg7 (button) folded before Flop (didn't bet)
Seat 5: fkf87 (small blind) showed [Td 9s] and lost with a full house, Tens full of Nines
Seat 6: Siim154 (big blind) folded before Flop



PokerStars Hand #164794853511:  Hold'em No Limit ($0.01/$0.02 USD) - 2017/01/18 16:05:48 ET
Table 'Dollfus II' 6-max Seat #6 is the button
Seat 1: pedroabreu1 ($4.75 in chips) 
Seat 3: bashbull ($2 in chips) 
Seat 4: Alfi_lg7 ($2.05 in chips) 
Seat 6: Siim154 ($2.08 in chips) 
pedroabreu1: posts small blind $0.01
bashbull: posts big blind $0.02
*** HOLE CARDS ***
Dealt to pedroabreu1 [4h Ad]
Alfi_lg7: folds 
Siim154: raises $0.04 to $0.06
pedroabreu1: folds 
bashbull: folds 
Uncalled bet ($0.04) returned to Siim154
Siim154 collected $0.05 from pot
Siim154: doesn't show hand 
*** SUMMARY ***
Total pot $0.05 | Rake $0 
Seat 1: pedroabreu1 (small blind) folded before Flop
Seat 3: bashbull (big blind) folded before Flop
Seat 4: Alfi_lg7 folded before Flop (didn't bet)
Seat 6: Siim154 (button) collected ($0.05)



PokerStars Hand #164794869962:  Hold'em No Limit ($0.01/$0.02 USD) - 2017/01/18 16:06:04 ET
Table 'Dollfus II' 6-max Seat #1 is the button
Seat 1: pedroabreu1 ($4.74 in chips) 
Seat 3: bashbull ($2 in chips) 
Seat 4: Alfi_lg7 ($2.05 in chips) 
Seat 6: Siim154 ($2.11 in chips) 
bashbull: posts small blind $0.01
Alfi_lg7: posts big blind $0.02
*** HOLE CARDS ***
Dealt to pedroabreu1 [9s 2d]
Siim154: raises $0.04 to $0.06
pedroabreu1: folds 
bashbull: raises $0.18 to $0.24
Alfi_lg7: folds 
Siim154: folds 
Uncalled bet ($0.18) returned to bashbull
bashbull collected $0.14 from pot
*** SUMMARY ***
Total pot $0.14 | Rake $0 
Seat 1: pedroabreu1 (button) folded before Flop (didn't bet)
Seat 3: bashbull (small blind) collected ($0.14)
Seat 4: Alfi_lg7 (big blind) folded before Flop
Seat 6: Siim154 folded before Flop



PokerStars Hand #164794891009:  Hold'em No Limit ($0.01/$0.02 USD) - 2017/01/18 16:06:27 ET
Table 'Dollfus II' 6-max Seat #3 is the button
Seat 1: pedroabreu1 ($4.74 in chips) 
Seat 3: bashbull ($2.08 in chips) 
Seat 4: Alfi_lg7 ($2.03 in chips) 
Seat 6: Siim154 ($2.05 in chips) 
Alfi_lg7: posts small blind $0.01
Siim154: posts big blind $0.02
*** HOLE CARDS ***
Dealt to pedroabreu1 [Jc 5c]
fkf87 is disconnected 
pedroabreu1: folds 
bashbull: raises $0.04 to $0.06
Alfi_lg7: folds 
Siim154: folds 
Uncalled bet ($0.04) returned to bashbull
bashbull collected $0.05 from pot
*** SUMMARY ***
Total pot $0.05 | Rake $0 
Seat 1: pedroabreu1 folded before Flop (didn't bet)
Seat 3: bashbull (button) collected ($0.05)
Seat 4: Alfi_lg7 (small blind) folded before Flop
Seat 6: Siim154 (big blind) folded before Flop



PokerStars Hand #164794914488:  Hold'em No Limit ($0.01/$0.02 USD) - 2017/01/18 16:06:49 ET
Table 'Dollfus II' 6-max Seat #4 is the button
Seat 1: pedroabreu1 ($4.74 in chips) 
Seat 3: bashbull ($2.11 in chips) 
Seat 4: Alfi_lg7 ($2.02 in chips) 
Seat 6: Siim154 ($2.03 in chips) 
Siim154: posts small blind $0.01
pedroabreu1: posts big blind $0.02
*** HOLE CARDS ***
Dealt to pedroabreu1 [4h 4c]
bashbull: raises $0.04 to $0.06
Alfi_lg7: folds 
Siim154: folds 
pedroabreu1: calls $0.04
*** FLOP *** [Js 7d 5c]
pedroabreu1: checks 
bashbull: bets $0.10
pedroabreu1: folds 
Uncalled bet ($0.10) returned to bashbull
bashbull collected $0.13 from pot
*** SUMMARY ***
Total pot $0.13 | Rake $0 
Board [Js 7d 5c]
Seat 1: pedroabreu1 (big blind) folded on the Flop
Seat 3: bashbull collected ($0.13)
Seat 4: Alfi_lg7 (button) folded before Flop (didn't bet)
Seat 6: Siim154 (small blind) folded before Flop



PokerStars Hand #164794956463:  Hold'em No Limit ($0.01/$0.02 USD) - 2017/01/18 16:07:31 ET
Table 'Dollfus II' 6-max Seat #6 is the button
Seat 1: pedroabreu1 ($4.68 in chips) 
Seat 3: bashbull ($2.18 in chips) 
Seat 4: Alfi_lg7 ($2.02 in chips) 
Seat 6: Siim154 ($2.02 in chips) 
pedroabreu1: posts small blind $0.01
Andalufin was removed from the table for failing to post
bashbull: posts big blind $0.02
*** HOLE CARDS ***
Dealt to pedroabreu1 [8s 7d]
Alfi_lg7: folds 
Siim154: raises $0.04 to $0.06
pedroabreu1: folds 
maslovaMKV joins the table at seat #2 
bashbull: folds 
Uncalled bet ($0.04) returned to Siim154
Siim154 collected $0.05 from pot
Siim154: doesn't show hand 
*** SUMMARY ***
Total pot $0.05 | Rake $0 
Seat 1: pedroabreu1 (small blind) folded before Flop
Seat 3: bashbull (big blind) folded before Flop
Seat 4: Alfi_lg7 folded before Flop (didn't bet)
Seat 6: Siim154 (button) collected ($0.05)



PokerStars Hand #164794970540:  Hold'em No Limit ($0.01/$0.02 USD) - 2017/01/18 16:07:44 ET
Table 'Dollfus II' 6-max Seat #1 is the button
Seat 1: pedroabreu1 ($4.67 in chips) 
Seat 3: bashbull ($2.16 in chips) 
Seat 4: Alfi_lg7 ($2.02 in chips) 
Seat 6: Siim154 ($2.05 in chips) 
maslovaMKV will be allowed to play after the button
bashbull: posts small blind $0.01
Alfi_lg7: posts big blind $0.02
*** HOLE CARDS ***
Dealt to pedroabreu1 [Qd 7c]
Siim154: raises $0.04 to $0.06
pedroabreu1: folds 
bashbull: calls $0.05
Alfi_lg7: folds 
*** FLOP *** [Ts 6s Ad]
bashbull: checks 
Siim154: bets $0.08
bashbull: folds 
Uncalled bet ($0.08) returned to Siim154
Siim154 collected $0.14 from pot
Siim154: doesn't show hand 
*** SUMMARY ***
Total pot $0.14 | Rake $0 
Board [Ts 6s Ad]
Seat 1: pedroabreu1 (button) folded before Flop (didn't bet)
Seat 3: bashbull (small blind) folded on the Flop
Seat 4: Alfi_lg7 (big blind) folded before Flop
Seat 6: Siim154 collected ($0.14)



PokerStars Hand #164795013701:  Hold'em No Limit ($0.01/$0.02 USD) - 2017/01/18 16:08:28 ET
Table 'Dollfus II' 6-max Seat #3 is the button
Seat 1: pedroabreu1 ($4.67 in chips) 
Seat 3: bashbull ($2.10 in chips) 
Seat 4: Alfi_lg7 ($2 in chips) 
Seat 6: Siim154 ($2.13 in chips) 
Alfi_lg7: posts small blind $0.01
Siim154: posts big blind $0.02
maslovaMKV: sits out 
*** HOLE CARDS ***
Dealt to pedroabreu1 [Td 6h]
pedroabreu1: folds 
bashbull: folds 
Alfi_lg7: folds 
Uncalled bet ($0.01) returned to Siim154
Siim154 collected $0.02 from pot
Siim154: doesn't show hand 
*** SUMMARY ***
Total pot $0.02 | Rake $0 
Seat 1: pedroabreu1 folded before Flop (didn't bet)
Seat 3: bashbull (button) folded before Flop (didn't bet)
Seat 4: Alfi_lg7 (small blind) folded before Flop
Seat 6: Siim154 (big blind) collected ($0.02)



PokerStars Hand #164795026766:  Hold'em No Limit ($0.01/$0.02 USD) - 2017/01/18 16:08:40 ET
Table 'Dollfus II' 6-max Seat #4 is the button
Seat 1: pedroabreu1 ($4.67 in chips) 
Seat 3: bashbull ($2.10 in chips) 
Seat 4: Alfi_lg7 ($2 in chips) 
Seat 6: Siim154 ($2.14 in chips) 
Siim154: posts small blind $0.01
pedroabreu1: posts big blind $0.02
maslovaMKV: sits out 
*** HOLE CARDS ***
Dealt to pedroabreu1 [2c Ad]
bashbull: folds 
Alfi_lg7: folds 
Siim154: folds 
Uncalled bet ($0.01) returned to pedroabreu1
pedroabreu1 collected $0.02 from pot
pedroabreu1: doesn't show hand 
*** SUMMARY ***
Total pot $0.02 | Rake $0 
Seat 1: pedroabreu1 (big blind) collected ($0.02)
Seat 3: bashbull folded before Flop (didn't bet)
Seat 4: Alfi_lg7 (button) folded before Flop (didn't bet)
Seat 6: Siim154 (small blind) folded before Flop



PokerStars Hand #164795039201:  Hold'em No Limit ($0.01/$0.02 USD) - 2017/01/18 16:08:53 ET
Table 'Dollfus II' 6-max Seat #6 is the button
Seat 1: pedroabreu1 ($4.68 in chips) 
Seat 2: maslovaMKV ($1.50 in chips) 
Seat 3: bashbull ($2.10 in chips) 
Seat 4: Alfi_lg7 ($2 in chips) 
Seat 6: Siim154 ($2.13 in chips) 
pedroabreu1: posts small blind $0.01
maslovaMKV: posts big blind $0.02
*** HOLE CARDS ***
Dealt to pedroabreu1 [Th 4d]
bashbull: raises $0.04 to $0.06
Alfi_lg7: folds 
Siim154: raises $0.12 to $0.18
pedroabreu1: folds 
maslovaMKV: folds 
bashbull: folds 
Uncalled bet ($0.12) returned to Siim154
Siim154 collected $0.15 from pot
Siim154: doesn't show hand 
*** SUMMARY ***
Total pot $0.15 | Rake $0 
Seat 1: pedroabreu1 (small blind) folded before Flop
Seat 2: maslovaMKV (big blind) folded before Flop
Seat 3: bashbull folded before Flop
Seat 4: Alfi_lg7 folded before Flop (didn't bet)
Seat 6: Siim154 (button) collected ($0.15)



PokerStars Hand #164795070966:  Hold'em No Limit ($0.01/$0.02 USD) - 2017/01/18 16:09:24 ET
Table 'Dollfus II' 6-max Seat #1 is the button
Seat 1: pedroabreu1 ($4.67 in chips) 
Seat 2: maslovaMKV ($1.50 in chips) 
Seat 3: bashbull ($2.04 in chips) 
Seat 4: Alfi_lg7 ($2 in chips) 
Seat 6: Siim154 ($2.22 in chips) 
maslovaMKV: posts small blind $0.01
bashbull: posts big blind $0.02
*** HOLE CARDS ***
Dealt to pedroabreu1 [Kh 3d]
Alfi_lg7: folds 
Siim154: folds 
pedroabreu1: folds 
maslovaMKV: calls $0.01
bashbull: checks 
*** FLOP *** [5c 2h 9c]
maslovaMKV: bets $0.02
bashbull: calls $0.02
*** TURN *** [5c 2h 9c] [7s]
maslovaMKV: bets $0.02
bashbull: calls $0.02
*** RIVER *** [5c 2h 9c 7s] [6s]
maslovaMKV: bets $0.12
bashbull: calls $0.12
*** SHOW DOWN ***
maslovaMKV: shows [8c 7d] (a straight, Five to Nine)
bashbull: mucks hand 
maslovaMKV collected $0.35 from pot
*** SUMMARY ***
Total pot $0.36 | Rake $0.01 
Board [5c 2h 9c 7s 6s]
Seat 1: pedroabreu1 (button) folded before Flop (didn't bet)
Seat 2: maslovaMKV (small blind) showed [8c 7d] and won ($0.35) with a straight, Five to Nine
Seat 3: bashbull (big blind) mucked [9h Qd]
Seat 4: Alfi_lg7 folded before Flop (didn't bet)
Seat 6: Siim154 folded before Flop (didn't bet)



PokerStars Hand #164795153052:  Hold'em No Limit ($0.01/$0.02 USD) - 2017/01/18 16:10:44 ET
Table 'Dollfus II' 6-max Seat #2 is the button
Seat 1: pedroabreu1 ($4.67 in chips) 
Seat 2: maslovaMKV ($1.67 in chips) 
Seat 3: bashbull ($2 in chips) 
Seat 4: Alfi_lg7 ($2 in chips) 
Seat 6: Siim154 ($2.22 in chips) 
bashbull: posts small blind $0.01
Alfi_lg7: posts big blind $0.02
*** HOLE CARDS ***
Dealt to pedroabreu1 [Ts As]
Siim154: raises $0.04 to $0.06
pedroabreu1: folds 
maslovaMKV: calls $0.06
bashbull: folds 
Alfi_lg7: calls $0.04
*** FLOP *** [Jd 7s 7h]
Alfi_lg7: checks 
Siim154: checks 
maslovaMKV: bets $0.02
Alfi_lg7: folds 
Siim154: calls $0.02
*** TURN *** [Jd 7s 7h] [Qh]
Siim154: checks 
maslovaMKV: checks 
*** RIVER *** [Jd 7s 7h Qh] [5s]
Siim154: checks 
maslovaMKV: checks 
*** SHOW DOWN ***
Siim154: shows [Kd Tc] (a pair of Sevens)
maslovaMKV: shows [3d 3c] (two pair, Sevens and Threes)
maslovaMKV collected $0.22 from pot
*** SUMMARY ***
Total pot $0.23 | Rake $0.01 
Board [Jd 7s 7h Qh 5s]
Seat 1: pedroabreu1 folded before Flop (didn't bet)
Seat 2: maslovaMKV (button) showed [3d 3c] and won ($0.22) with two pair, Sevens and Threes
Seat 3: bashbull (small blind) folded before Flop
Seat 4: Alfi_lg7 (big blind) folded on the Flop
Seat 6: Siim154 showed [Kd Tc] and lost with a pair of Sevens



PokerStars Hand #164795234833:  Hold'em No Limit ($0.01/$0.02 USD) - 2017/01/18 16:12:05 ET
Table 'Dollfus II' 6-max Seat #3 is the button
Seat 1: pedroabreu1 ($4.67 in chips) 
Seat 2: maslovaMKV ($1.81 in chips) 
Seat 3: bashbull ($2 in chips) 
Seat 4: Alfi_lg7 ($2 in chips) 
Seat 6: Siim154 ($2.14 in chips) 
Alfi_lg7: posts small blind $0.01
Siim154: posts big blind $0.02
*** HOLE CARDS ***
Dealt to pedroabreu1 [Ks 6s]
pedroabreu1: folds 
maslovaMKV: raises $0.04 to $0.06
bashbull: folds 
Alfi_lg7: folds 
Siim154: folds 
Uncalled bet ($0.04) returned to maslovaMKV
maslovaMKV collected $0.05 from pot
*** SUMMARY ***
Total pot $0.05 | Rake $0 
Seat 1: pedroabreu1 folded before Flop (didn't bet)
Seat 2: maslovaMKV collected ($0.05)
Seat 3: bashbull (button) folded before Flop (didn't bet)
Seat 4: Alfi_lg7 (small blind) folded before Flop
Seat 6: Siim154 (big blind) folded before Flop



PokerStars Hand #164795282198:  Hold'em No Limit ($0.01/$0.02 USD) - 2017/01/18 16:12:52 ET
Table 'Dollfus II' 6-max Seat #4 is the button
Seat 1: pedroabreu1 ($4.67 in chips) 
Seat 2: maslovaMKV ($1.84 in chips) 
Seat 3: bashbull ($2 in chips) 
Seat 4: Alfi_lg7 ($2 in chips) 
Seat 6: Siim154 ($2.12 in chips) 
Siim154: posts small blind $0.01
pedroabreu1: posts big blind $0.02
*** HOLE CARDS ***
Dealt to pedroabreu1 [5d 6c]
maslovaMKV: calls $0.02
bashbull: folds 
Alfi_lg7: raises $0.02 to $0.04
Siim154: folds 
pedroabreu1: folds 
maslovaMKV: calls $0.02
*** FLOP *** [Qd 3d As]
maslovaMKV: checks 
Alfi_lg7: bets $0.20
maslovaMKV: folds 
Uncalled bet ($0.20) returned to Alfi_lg7
Alfi_lg7 collected $0.11 from pot
Alfi_lg7: doesn't show hand 
*** SUMMARY ***
Total pot $0.11 | Rake $0 
Board [Qd 3d As]
Seat 1: pedroabreu1 (big blind) folded before Flop
Seat 2: maslovaMKV folded on the Flop
Seat 3: bashbull folded before Flop (didn't bet)
Seat 4: Alfi_lg7 (button) collected ($0.11)
Seat 6: Siim154 (small blind) folded before Flop



PokerStars Hand #164795340691:  Hold'em No Limit ($0.01/$0.02 USD) - 2017/01/18 16:13:49 ET
Table 'Dollfus II' 6-max Seat #6 is the button
Seat 1: pedroabreu1 ($4.65 in chips) 
Seat 2: maslovaMKV ($1.80 in chips) 
Seat 3: bashbull ($2 in chips) 
Seat 4: Alfi_lg7 ($2.07 in chips) 
Seat 6: Siim154 ($2.11 in chips) 
pedroabreu1: posts small blind $0.01
maslovaMKV: posts big blind $0.02
*** HOLE CARDS ***
Dealt to pedroabreu1 [5d 3s]
bashbull: folds 
Alfi_lg7: folds 
Siim154: raises $0.04 to $0.06
pedroabreu1: folds 
maslovaMKV: folds 
Uncalled bet ($0.04) returned to Siim154
Siim154 collected $0.05 from pot
Siim154: doesn't show hand 
*** SUMMARY ***
Total pot $0.05 | Rake $0 
Seat 1: pedroabreu1 (small blind) folded before Flop
Seat 2: maslovaMKV (big blind) folded before Flop
Seat 3: bashbull folded before Flop (didn't bet)
Seat 4: Alfi_lg7 folded before Flop (didn't bet)
Seat 6: Siim154 (button) collected ($0.05)



PokerStars Hand #164795368877:  Hold'em No Limit ($0.01/$0.02 USD) - 2017/01/18 16:14:16 ET
Table 'Dollfus II' 6-max Seat #1 is the button
Seat 1: pedroabreu1 ($4.64 in chips) 
Seat 2: maslovaMKV ($1.78 in chips) 
Seat 3: bashbull ($2 in chips) 
Seat 4: Alfi_lg7 ($2.07 in chips) 
Seat 6: Siim154 ($2.14 in chips) 
maslovaMKV: posts small blind $0.01
bashbull: posts big blind $0.02
*** HOLE CARDS ***
Dealt to pedroabreu1 [8d 5c]
Alfi_lg7: raises $0.06 to $0.08
Siim154: folds 
pedroabreu1: folds 
maslovaMKV: calls $0.07
bashbull: folds 
*** FLOP *** [Ts 2s 3s]
maslovaMKV: checks 
Alfi_lg7: checks 
*** TURN *** [Ts 2s 3s] [Td]
maslovaMKV: checks 
Alfi_lg7: checks 
*** RIVER *** [Ts 2s 3s Td] [Qc]
maslovaMKV: checks 
Alfi_lg7: checks 
*** SHOW DOWN ***
maslovaMKV: shows [9h 9c] (two pair, Tens and Nines)
Alfi_lg7: mucks hand 
maslovaMKV collected $0.17 from pot
*** SUMMARY ***
Total pot $0.18 | Rake $0.01 
Board [Ts 2s 3s Td Qc]
Seat 1: pedroabreu1 (button) folded before Flop (didn't bet)
Seat 2: maslovaMKV (small blind) showed [9h 9c] and won ($0.17) with two pair, Tens and Nines
Seat 3: bashbull (big blind) folded before Flop
Seat 4: Alfi_lg7 mucked [Ad Jh]
Seat 6: Siim154 folded before Flop (didn't bet)



PokerStars Hand #164795426744:  Hold'em No Limit ($0.01/$0.02 USD) - 2017/01/18 16:15:14 ET
Table 'Dollfus II' 6-max Seat #2 is the button
Seat 1: pedroabreu1 ($4.64 in chips) 
Seat 2: maslovaMKV ($1.87 in chips) 
Seat 3: bashbull ($2 in chips) 
Seat 4: Alfi_lg7 ($2 in chips) 
Seat 6: Siim154 ($2.14 in chips) 
bashbull: posts small blind $0.01
Alfi_lg7: posts big blind $0.02
*** HOLE CARDS ***
Dealt to pedroabreu1 [Tc 7s]
Siim154: folds 
pedroabreu1: folds 
maslovaMKV: folds 
bashbull: raises $0.04 to $0.06
Alfi_lg7: folds 
Uncalled bet ($0.04) returned to bashbull
bashbull collected $0.04 from pot
*** SUMMARY ***
Total pot $0.04 | Rake $0 
Seat 1: pedroabreu1 folded before Flop (didn't bet)
Seat 2: maslovaMKV (button) folded before Flop (didn't bet)
Seat 3: bashbull (small blind) collected ($0.04)
Seat 4: Alfi_lg7 (big blind) folded before Flop
Seat 6: Siim154 folded before Flop (didn't bet)



PokerStars Hand #164795442519:  Hold'em No Limit ($0.01/$0.02 USD) - 2017/01/18 16:15:29 ET
Table 'Dollfus II' 6-max Seat #3 is the button
Seat 1: pedroabreu1 ($4.64 in chips) 
Seat 2: maslovaMKV ($1.87 in chips) 
Seat 3: bashbull ($2.02 in chips) 
Seat 4: Alfi_lg7 ($2 in chips) 
Seat 6: Siim154 ($2.14 in chips) 
Alfi_lg7: posts small blind $0.01
Siim154: posts big blind $0.02
*** HOLE CARDS ***
Dealt to pedroabreu1 [6d Jd]
pedroabreu1: folds 
maslovaMKV: folds 
bashbull: raises $0.04 to $0.06
Alfi_lg7: folds 
Siim154: folds 
Uncalled bet ($0.04) returned to bashbull
bashbull collected $0.05 from pot
*** SUMMARY ***
Total pot $0.05 | Rake $0 
Seat 1: pedroabreu1 folded before Flop (didn't bet)
Seat 2: maslovaMKV folded before Flop (didn't bet)
Seat 3: bashbull (button) collected ($0.05)
Seat 4: Alfi_lg7 (small blind) folded before Flop
Seat 6: Siim154 (big blind) folded before Flop



PokerStars Hand #164795462885:  Hold'em No Limit ($0.01/$0.02 USD) - 2017/01/18 16:15:49 ET
Table 'Dollfus II' 6-max Seat #4 is the button
Seat 1: pedroabreu1 ($4.64 in chips) 
Seat 2: maslovaMKV ($1.87 in chips) 
Seat 3: bashbull ($2.05 in chips) 
Seat 4: Alfi_lg7 ($2 in chips) 
Seat 6: Siim154 ($2.12 in chips) 
Siim154: posts small blind $0.01
pedroabreu1: posts big blind $0.02
*** HOLE CARDS ***
Dealt to pedroabreu1 [Jc Td]
maslovaMKV: folds 
bashbull: folds 
Alfi_lg7: folds 
Siim154: folds 
Uncalled bet ($0.01) returned to pedroabreu1
pedroabreu1 collected $0.02 from pot
pedroabreu1: doesn't show hand 
*** SUMMARY ***
Total pot $0.02 | Rake $0 
Seat 1: pedroabreu1 (big blind) collected ($0.02)
Seat 2: maslovaMKV folded before Flop (didn't bet)
Seat 3: bashbull folded before Flop (didn't bet)
Seat 4: Alfi_lg7 (button) folded before Flop (didn't bet)
Seat 6: Siim154 (small blind) folded before Flop



PokerStars Hand #164795484834:  Hold'em No Limit ($0.01/$0.02 USD) - 2017/01/18 16:16:10 ET
Table 'Dollfus II' 6-max Seat #6 is the button
Seat 1: pedroabreu1 ($4.65 in chips) 
Seat 2: maslovaMKV ($1.87 in chips) 
Seat 3: bashbull ($2.05 in chips) 
Seat 4: Alfi_lg7 ($2 in chips) 
Seat 6: Siim154 ($2.11 in chips) 
pedroabreu1: posts small blind $0.01
maslovaMKV: posts big blind $0.02
*** HOLE CARDS ***
Dealt to pedroabreu1 [3c 4h]
bashbull: folds 
Alfi_lg7: folds 
Siim154: raises $0.04 to $0.06
pedroabreu1: folds 
maslovaMKV: calls $0.04
*** FLOP *** [Ts Qd 6s]
fkf87 was removed from the table for failing to post
maslovaMKV: checks 
BI0W0LF joins the table at seat #5 
Siim154: bets $0.08
maslovaMKV: folds 
Uncalled bet ($0.08) returned to Siim154
Siim154 collected $0.13 from pot
Siim154: doesn't show hand 
*** SUMMARY ***
Total pot $0.13 | Rake $0 
Board [Ts Qd 6s]
Seat 1: pedroabreu1 (small blind) folded before Flop
Seat 2: maslovaMKV (big blind) folded on the Flop
Seat 3: bashbull folded before Flop (didn't bet)
Seat 4: Alfi_lg7 folded before Flop (didn't bet)
Seat 6: Siim154 (button) collected ($0.13)



PokerStars Hand #164795524014:  Hold'em No Limit ($0.01/$0.02 USD) - 2017/01/18 16:16:49 ET
Table 'Dollfus II' 6-max Seat #1 is the button
Seat 1: pedroabreu1 ($4.64 in chips) 
Seat 2: maslovaMKV ($1.81 in chips) 
Seat 3: bashbull ($2.05 in chips) 
Seat 4: Alfi_lg7 ($2 in chips) 
Seat 6: Siim154 ($2.18 in chips) 
maslovaMKV: posts small blind $0.01
bashbull: posts big blind $0.02
BI0W0LF: sits out 
*** HOLE CARDS ***
Dealt to pedroabreu1 [3s 5c]
Alfi_lg7: folds 
Siim154: folds 
pedroabreu1: folds 
maslovaMKV: folds 
Uncalled bet ($0.01) returned to bashbull
bashbull collected $0.02 from pot
*** SUMMARY ***
Total pot $0.02 | Rake $0 
Seat 1: pedroabreu1 (button) folded before Flop (didn't bet)
Seat 2: maslovaMKV (small blind) folded before Flop
Seat 3: bashbull (big blind) collected ($0.02)
Seat 4: Alfi_lg7 folded before Flop (didn't bet)
Seat 6: Siim154 folded before Flop (didn't bet)



PokerStars Hand #164795546380:  Hold'em No Limit ($0.01/$0.02 USD) - 2017/01/18 16:17:10 ET
Table 'Dollfus II' 6-max Seat #2 is the button
Seat 1: pedroabreu1 ($4.64 in chips) 
Seat 2: maslovaMKV ($1.80 in chips) 
Seat 3: bashbull ($2.06 in chips) 
Seat 4: Alfi_lg7 ($2 in chips) 
Seat 6: Siim154 ($2.18 in chips) 
bashbull: posts small blind $0.01
Alfi_lg7: posts big blind $0.02
BI0W0LF: sits out 
*** HOLE CARDS ***
Dealt to pedroabreu1 [2d Th]
Siim154: raises $0.04 to $0.06
pedroabreu1: folds 
maslovaMKV: folds 
bashbull: raises $2 to $2.06 and is all-in
Alfi_lg7: folds 
Siim154: folds 
Uncalled bet ($2) returned to bashbull
bashbull collected $0.14 from pot
*** SUMMARY ***
Total pot $0.14 | Rake $0 
Seat 1: pedroabreu1 folded before Flop (didn't bet)
Seat 2: maslovaMKV (button) folded before Flop (didn't bet)
Seat 3: bashbull (small blind) collected ($0.14)
Seat 4: Alfi_lg7 (big blind) folded before Flop
Seat 6: Siim154 folded before Flop



PokerStars Hand #164795567303:  Hold'em No Limit ($0.01/$0.02 USD) - 2017/01/18 16:17:31 ET
Table 'Dollfus II' 6-max Seat #3 is the button
Seat 1: pedroabreu1 ($4.64 in chips) 
Seat 2: maslovaMKV ($1.80 in chips) 
Seat 3: bashbull ($2.14 in chips) 
Seat 4: Alfi_lg7 ($2 in chips) 
Seat 5: BI0W0LF ($2 in chips) 
Seat 6: Siim154 ($2.12 in chips) 
Alfi_lg7: posts small blind $0.01
BI0W0LF: posts big blind $0.02
*** HOLE CARDS ***
Dealt to pedroabreu1 [Th 3s]
Siim154: folds 
pedroabreu1: folds 
maslovaMKV: folds 
bashbull: folds 
Alfi_lg7: folds 
Uncalled bet ($0.01) returned to BI0W0LF
BI0W0LF collected $0.02 from pot
BI0W0LF: doesn't show hand 
*** SUMMARY ***
Total pot $0.02 | Rake $0 
Seat 1: pedroabreu1 folded before Flop (didn't bet)
Seat 2: maslovaMKV folded before Flop (didn't bet)
Seat 3: bashbull (button) folded before Flop (didn't bet)
Seat 4: Alfi_lg7 (small blind) folded before Flop
Seat 5: BI0W0LF (big blind) collected ($0.02)
Seat 6: Siim154 folded before Flop (didn't bet)



PokerStars Hand #164795585017:  Hold'em No Limit ($0.01/$0.02 USD) - 2017/01/18 16:17:48 ET
Table 'Dollfus II' 6-max Seat #4 is the button
Seat 1: pedroabreu1 ($4.64 in chips) 
Seat 2: maslovaMKV ($1.80 in chips) 
Seat 3: bashbull ($2.14 in chips) 
Seat 4: Alfi_lg7 ($2 in chips) 
Seat 5: BI0W0LF ($2.01 in chips) 
Seat 6: Siim154 ($2.12 in chips) 
BI0W0LF: posts small blind $0.01
Siim154: posts big blind $0.02
*** HOLE CARDS ***
Dealt to pedroabreu1 [Qs Jc]
pedroabreu1: folds 
maslovaMKV: folds 
bashbull: folds 
Alfi_lg7: folds 
BI0W0LF: raises $0.03 to $0.05
Siim154: folds 
Uncalled bet ($0.03) returned to BI0W0LF
BI0W0LF collected $0.04 from pot
BI0W0LF: doesn't show hand 
*** SUMMARY ***
Total pot $0.04 | Rake $0 
Seat 1: pedroabreu1 folded before Flop (didn't bet)
Seat 2: maslovaMKV folded before Flop (didn't bet)
Seat 3: bashbull folded before Flop (didn't bet)
Seat 4: Alfi_lg7 (button) folded before Flop (didn't bet)
Seat 5: BI0W0LF (small blind) collected ($0.04)
Seat 6: Siim154 (big blind) folded before Flop



PokerStars Hand #164795630679:  Hold'em No Limit ($0.01/$0.02 USD) - 2017/01/18 16:18:34 ET
Table 'Dollfus II' 6-max Seat #5 is the button
Seat 1: pedroabreu1 ($4.64 in chips) 
Seat 2: maslovaMKV ($1.80 in chips) 
Seat 3: bashbull ($2.14 in chips) 
Seat 4: Alfi_lg7 ($2 in chips) 
Seat 5: BI0W0LF ($2.03 in chips) 
Seat 6: Siim154 ($2.10 in chips) 
Siim154: posts small blind $0.01
pedroabreu1: posts big blind $0.02
*** HOLE CARDS ***
Dealt to pedroabreu1 [6c 4d]
maslovaMKV: folds 
bashbull: folds 
Alfi_lg7: raises $0.06 to $0.08
BI0W0LF: folds 
Siim154: folds 
pedroabreu1: folds 
Uncalled bet ($0.06) returned to Alfi_lg7
Alfi_lg7 collected $0.05 from pot
Alfi_lg7: doesn't show hand 
*** SUMMARY ***
Total pot $0.05 | Rake $0 
Seat 1: pedroabreu1 (big blind) folded before Flop
Seat 2: maslovaMKV folded before Flop (didn't bet)
Seat 3: bashbull folded before Flop (didn't bet)
Seat 4: Alfi_lg7 collected ($0.05)
Seat 5: BI0W0LF (button) folded before Flop (didn't bet)
Seat 6: Siim154 (small blind) folded before Flop



PokerStars Hand #164795679989:  Hold'em No Limit ($0.01/$0.02 USD) - 2017/01/18 16:19:23 ET
Table 'Dollfus II' 6-max Seat #6 is the button
Seat 1: pedroabreu1 ($4.62 in chips) 
Seat 2: maslovaMKV ($1.80 in chips) 
Seat 3: bashbull ($2.14 in chips) 
Seat 4: Alfi_lg7 ($2.03 in chips) 
Seat 5: BI0W0LF ($2.03 in chips) 
Seat 6: Siim154 ($2.09 in chips) 
pedroabreu1: posts small blind $0.01
maslovaMKV: posts big blind $0.02
*** HOLE CARDS ***
Dealt to pedroabreu1 [Ks 2d]
bashbull: folds 
Alfi_lg7: folds 
BI0W0LF: folds 
Siim154: raises $0.04 to $0.06
pedroabreu1: folds 
maslovaMKV: folds 
Uncalled bet ($0.04) returned to Siim154
Siim154 collected $0.05 from pot
Siim154: doesn't show hand 
*** SUMMARY ***
Total pot $0.05 | Rake $0 
Seat 1: pedroabreu1 (small blind) folded before Flop
Seat 2: maslovaMKV (big blind) folded before Flop
Seat 3: bashbull folded before Flop (didn't bet)
Seat 4: Alfi_lg7 folded before Flop (didn't bet)
Seat 5: BI0W0LF folded before Flop (didn't bet)
Seat 6: Siim154 (button) collected ($0.05)



PokerStars Hand #164795704983:  Hold'em No Limit ($0.01/$0.02 USD) - 2017/01/18 16:19:47 ET
Table 'Dollfus II' 6-max Seat #1 is the button
Seat 1: pedroabreu1 ($4.61 in chips) 
Seat 2: maslovaMKV ($1.78 in chips) 
Seat 3: bashbull ($2.14 in chips) 
Seat 4: Alfi_lg7 ($2.03 in chips) 
Seat 5: BI0W0LF ($2.03 in chips) 
Seat 6: Siim154 ($2.12 in chips) 
maslovaMKV: posts small blind $0.01
bashbull: posts big blind $0.02
*** HOLE CARDS ***
Dealt to pedroabreu1 [Qh Jh]
Alfi_lg7: folds 
BI0W0LF: folds 
Siim154: folds 
pedroabreu1: raises $0.04 to $0.06
maslovaMKV: calls $0.05
bashbull: calls $0.04
*** FLOP *** [3h 4s 9s]
maslovaMKV: checks 
bashbull: bets $0.13
pedroabreu1: calls $0.13
maslovaMKV: folds 
*** TURN *** [3h 4s 9s] [5c]
bashbull: checks 
pedroabreu1: checks 
*** RIVER *** [3h 4s 9s 5c] [6h]
bashbull: checks 
pedroabreu1: checks 
*** SHOW DOWN ***
bashbull: shows [9h Tc] (a pair of Nines)
pedroabreu1: mucks hand 
bashbull collected $0.42 from pot
*** SUMMARY ***
Total pot $0.44 | Rake $0.02 
Board [3h 4s 9s 5c 6h]
Seat 1: pedroabreu1 (button) mucked [Qh Jh]
Seat 2: maslovaMKV (small blind) folded on the Flop
Seat 3: bashbull (big blind) showed [9h Tc] and won ($0.42) with a pair of Nines
Seat 4: Alfi_lg7 folded before Flop (didn't bet)
Seat 5: BI0W0LF folded before Flop (didn't bet)
Seat 6: Siim154 folded before Flop (didn't bet)



PokerStars Hand #164795799396:  Hold'em No Limit ($0.01/$0.02 USD) - 2017/01/18 16:21:22 ET
Table 'Dollfus II' 6-max Seat #2 is the button
Seat 1: pedroabreu1 ($4.42 in chips) 
Seat 2: maslovaMKV ($1.72 in chips) 
Seat 3: bashbull ($2.37 in chips) 
Seat 4: Alfi_lg7 ($2.03 in chips) 
Seat 5: BI0W0LF ($2.03 in chips) 
Seat 6: Siim154 ($2.12 in chips) 
bashbull: posts small blind $0.01
Alfi_lg7: posts big blind $0.02
*** HOLE CARDS ***
Dealt to pedroabreu1 [Td 5c]
BI0W0LF: folds 
Siim154: folds 
pedroabreu1: folds 
maslovaMKV: calls $0.02
bashbull: folds 
Alfi_lg7: checks 
*** FLOP *** [7d Ah 6d]
Alfi_lg7: checks 
maslovaMKV: checks 
*** TURN *** [7d Ah 6d] [7s]
Alfi_lg7: checks 
maslovaMKV: bets $0.02
Alfi_lg7: folds 
Uncalled bet ($0.02) returned to maslovaMKV
maslovaMKV collected $0.05 from pot
*** SUMMARY ***
Total pot $0.05 | Rake $0 
Board [7d Ah 6d 7s]
Seat 1: pedroabreu1 folded before Flop (didn't bet)
Seat 2: maslovaMKV (button) collected ($0.05)
Seat 3: bashbull (small blind) folded before Flop
Seat 4: Alfi_lg7 (big blind) folded on the Turn
Seat 5: BI0W0LF folded before Flop (didn't bet)
Seat 6: Siim154 folded before Flop (didn't bet)



PokerStars Hand #164795845651:  Hold'em No Limit ($0.01/$0.02 USD) - 2017/01/18 16:22:07 ET
Table 'Dollfus II' 6-max Seat #3 is the button
Seat 1: pedroabreu1 ($4.42 in chips) 
Seat 2: maslovaMKV ($1.75 in chips) 
Seat 3: bashbull ($2.36 in chips) 
Seat 4: Alfi_lg7 ($2.01 in chips) 
Alfi_lg7: posts small blind $0.01
BI0W0LF: is sitting out 
BI0W0LF leaves the table
Siim154: is sitting out 
pedroabreu1: posts big blind $0.02
*** HOLE CARDS ***
Dealt to pedroabreu1 [Qd 7s]
Siim154 leaves the table
maslovaMKV: folds 
bashbull: raises $0.04 to $0.06
Alfi_lg7: calls $0.05
pedroabreu1: folds 
*** FLOP *** [4s 5s 9s]
Alfi_lg7: bets $0.20
bashbull: folds 
Uncalled bet ($0.20) returned to Alfi_lg7
Alfi_lg7 collected $0.14 from pot
Alfi_lg7: doesn't show hand 
*** SUMMARY ***
Total pot $0.14 | Rake $0 
Board [4s 5s 9s]
Seat 1: pedroabreu1 (big blind) folded before Flop
Seat 2: maslovaMKV folded before Flop (didn't bet)
Seat 3: bashbull (button) folded on the Flop
Seat 4: Alfi_lg7 (small blind) collected ($0.14)



PokerStars Hand #164795883410:  Hold'em No Limit ($0.01/$0.02 USD) - 2017/01/18 16:22:45 ET
Table 'Dollfus II' 6-max Seat #4 is the button
Seat 1: pedroabreu1 ($4.40 in chips) 
Seat 2: maslovaMKV ($1.75 in chips) 
Seat 3: bashbull ($2.30 in chips) 
Seat 4: Alfi_lg7 ($2.09 in chips) 
pedroabreu1: posts small blind $0.01
maslovaMKV: posts big blind $0.02
*** HOLE CARDS ***
Dealt to pedroabreu1 [4s Ad]
bashbull: folds 
Alfi_lg7: folds 
pedroabreu1: folds 
Uncalled bet ($0.01) returned to maslovaMKV
maslovaMKV collected $0.02 from pot
*** SUMMARY ***
Total pot $0.02 | Rake $0 
Seat 1: pedroabreu1 (small blind) folded before Flop
Seat 2: maslovaMKV (big blind) collected ($0.02)
Seat 3: bashbull folded before Flop (didn't bet)
Seat 4: Alfi_lg7 (button) folded before Flop (didn't bet)



PokerStars Hand #164795906681:  Hold'em No Limit ($0.01/$0.02 USD) - 2017/01/18 16:23:08 ET
Table 'Dollfus II' 6-max Seat #1 is the button
Seat 1: pedroabreu1 ($4.39 in chips) 
Seat 2: maslovaMKV ($1.76 in chips) 
Seat 3: bashbull ($2.30 in chips) 
Seat 4: Alfi_lg7 ($2.09 in chips) 
maslovaMKV: posts small blind $0.01
bashbull: posts big blind $0.02
*** HOLE CARDS ***
Dealt to pedroabreu1 [Kc 7h]
Alfi_lg7: folds 
pedroabreu1: folds 
maslovaMKV: calls $0.01
bashbull: checks 
*** FLOP *** [4h Jc 4s]
maslovaMKV: bets $0.02
bashbull: folds 
Uncalled bet ($0.02) returned to maslovaMKV
maslovaMKV collected $0.04 from pot
*** SUMMARY ***
Total pot $0.04 | Rake $0 
Board [4h Jc 4s]
Seat 1: pedroabreu1 (button) folded before Flop (didn't bet)
Seat 2: maslovaMKV (small blind) collected ($0.04)
Seat 3: bashbull (big blind) folded on the Flop
Seat 4: Alfi_lg7 folded before Flop (didn't bet)



PokerStars Hand #164795946048:  Hold'em No Limit ($0.01/$0.02 USD) - 2017/01/18 16:23:47 ET
Table 'Dollfus II' 6-max Seat #2 is the button
Seat 1: pedroabreu1 ($4.39 in chips) 
Seat 2: maslovaMKV ($1.78 in chips) 
Seat 3: bashbull ($2.28 in chips) 
Seat 4: Alfi_lg7 ($2.09 in chips) 
bashbull: posts small blind $0.01
Alfi_lg7: posts big blind $0.02
*** HOLE CARDS ***
Dealt to pedroabreu1 [5d 3d]
pedroabreu1: folds 
maslovaMKV: folds 
bashbull: folds 
Uncalled bet ($0.01) returned to Alfi_lg7
Alfi_lg7 collected $0.02 from pot
Alfi_lg7: doesn't show hand 
*** SUMMARY ***
Total pot $0.02 | Rake $0 
Seat 1: pedroabreu1 folded before Flop (didn't bet)
Seat 2: maslovaMKV (button) folded before Flop (didn't bet)
Seat 3: bashbull (small blind) folded before Flop
Seat 4: Alfi_lg7 (big blind) collected ($0.02)



PokerStars Hand #164795968611:  Hold'em No Limit ($0.01/$0.02 USD) - 2017/01/18 16:24:09 ET
Table 'Dollfus II' 6-max Seat #3 is the button
Seat 1: pedroabreu1 ($4.39 in chips) 
Seat 2: maslovaMKV ($1.78 in chips) 
Seat 3: bashbull ($2.27 in chips) 
Seat 4: Alfi_lg7 ($2.10 in chips) 
Alfi_lg7: posts small blind $0.01
pedroabreu1: posts big blind $0.02
*** HOLE CARDS ***
Dealt to pedroabreu1 [8h 2c]
maslovaMKV: folds 
bashbull: folds 
Alfi_lg7: folds 
Uncalled bet ($0.01) returned to pedroabreu1
pedroabreu1 collected $0.02 from pot
pedroabreu1: doesn't show hand 
*** SUMMARY ***
Total pot $0.02 | Rake $0 
Seat 1: pedroabreu1 (big blind) collected ($0.02)
Seat 2: maslovaMKV folded before Flop (didn't bet)
Seat 3: bashbull (button) folded before Flop (didn't bet)
Seat 4: Alfi_lg7 (small blind) folded before Flop



PokerStars Hand #164795984144:  Hold'em No Limit ($0.01/$0.02 USD) - 2017/01/18 16:24:25 ET
Table 'Dollfus II' 6-max Seat #4 is the button
Seat 1: pedroabreu1 ($4.40 in chips) 
Seat 2: maslovaMKV ($1.78 in chips) 
Seat 3: bashbull ($2.27 in chips) 
Seat 4: Alfi_lg7 ($2.09 in chips) 
pedroabreu1: posts small blind $0.01
maslovaMKV: posts big blind $0.02
*** HOLE CARDS ***
Dealt to pedroabreu1 [8d 8h]
bashbull: folds 
Alfi_lg7: folds 
pedroabreu1: raises $0.04 to $0.06
maslovaMKV: folds 
Uncalled bet ($0.04) returned to pedroabreu1
pedroabreu1 collected $0.04 from pot
*** SUMMARY ***
Total pot $0.04 | Rake $0 
Seat 1: pedroabreu1 (small blind) collected ($0.04)
Seat 2: maslovaMKV (big blind) folded before Flop
Seat 3: bashbull folded before Flop (didn't bet)
Seat 4: Alfi_lg7 (button) folded before Flop (didn't bet)



PokerStars Hand #164796028241:  Hold'em No Limit ($0.01/$0.02 USD) - 2017/01/18 16:25:09 ET
Table 'Dollfus II' 6-max Seat #1 is the button
Seat 1: pedroabreu1 ($4.42 in chips) 
Seat 2: maslovaMKV ($1.76 in chips) 
Seat 3: bashbull ($2.27 in chips) 
Seat 4: Alfi_lg7 ($2.09 in chips) 
maslovaMKV: posts small blind $0.01
bashbull: posts big blind $0.02
*** HOLE CARDS ***
Dealt to pedroabreu1 [3h 9d]
Alfi_lg7: folds 
pedroabreu1: folds 
maslovaMKV: calls $0.01
bashbull: checks 
*** FLOP *** [Jc Kh Kd]
maslovaMKV: checks 
bashbull: bets $0.04
maslovaMKV: calls $0.04
*** TURN *** [Jc Kh Kd] [4h]
maslovaMKV: checks 
bashbull: bets $0.09
maslovaMKV: folds 
Uncalled bet ($0.09) returned to bashbull
bashbull collected $0.12 from pot
*** SUMMARY ***
Total pot $0.12 | Rake $0 
Board [Jc Kh Kd 4h]
Seat 1: pedroabreu1 (button) folded before Flop (didn't bet)
Seat 2: maslovaMKV (small blind) folded on the Turn
Seat 3: bashbull (big blind) collected ($0.12)
Seat 4: Alfi_lg7 folded before Flop (didn't bet)



PokerStars Hand #164796099209:  Hold'em No Limit ($0.01/$0.02 USD) - 2017/01/18 16:26:15 ET
Table 'Dollfus II' 6-max Seat #2 is the button
Seat 1: pedroabreu1 ($4.42 in chips) 
Seat 2: maslovaMKV ($1.70 in chips) 
Seat 3: bashbull ($2.33 in chips) 
Seat 4: Alfi_lg7 ($2.09 in chips) 
bashbull: posts small blind $0.01
Alfi_lg7: posts big blind $0.02
*** HOLE CARDS ***
Dealt to pedroabreu1 [8c Td]
pedroabreu1: folds 
ZOLOTO- XAXA joins the table at seat #6 
maslovaMKV: folds 
bashbull: folds 
Uncalled bet ($0.01) returned to Alfi_lg7
Alfi_lg7 collected $0.02 from pot
Alfi_lg7: doesn't show hand 
*** SUMMARY ***
Total pot $0.02 | Rake $0 
Seat 1: pedroabreu1 folded before Flop (didn't bet)
Seat 2: maslovaMKV (button) folded before Flop (didn't bet)
Seat 3: bashbull (small blind) folded before Flop
Seat 4: Alfi_lg7 (big blind) collected ($0.02)



PokerStars Hand #164796112447:  Hold'em No Limit ($0.01/$0.02 USD) - 2017/01/18 16:26:28 ET
Table 'Dollfus II' 6-max Seat #3 is the button
Seat 1: pedroabreu1 ($4.42 in chips) 
Seat 2: maslovaMKV ($1.70 in chips) 
Seat 3: bashbull ($2.32 in chips) 
Seat 4: Alfi_lg7 ($2.10 in chips) 
Seat 6: ZOLOTO- XAXA ($2 in chips) 
Alfi_lg7: posts small blind $0.01
ZOLOTO- XAXA: posts big blind $0.02
*** HOLE CARDS ***
Dealt to pedroabreu1 [Jh Jd]
pedroabreu1: raises $0.04 to $0.06
maslovaMKV: calls $0.06
OtB_PeruVian joins the table at seat #5 
bashbull: folds 
Alfi_lg7: folds 
ZOLOTO- XAXA: folds 
*** FLOP *** [9s 5s 2c]
pedroabreu1: bets $0.08
maslovaMKV: folds 
Uncalled bet ($0.08) returned to pedroabreu1
pedroabreu1 collected $0.14 from pot
pedroabreu1: doesn't show hand 
*** SUMMARY ***
Total pot $0.15 | Rake $0.01 
Board [9s 5s 2c]
Seat 1: pedroabreu1 collected ($0.14)
Seat 2: maslovaMKV folded on the Flop
Seat 3: bashbull (button) folded before Flop (didn't bet)
Seat 4: Alfi_lg7 (small blind) folded before Flop
Seat 6: ZOLOTO- XAXA (big blind) folded before Flop



PokerStars Hand #164796147083:  Hold'em No Limit ($0.01/$0.02 USD) - 2017/01/18 16:27:03 ET
Table 'Dollfus II' 6-max Seat #4 is the button
Seat 1: pedroabreu1 ($4.50 in chips) 
Seat 2: maslovaMKV ($1.64 in chips) 
Seat 3: bashbull ($2.32 in chips) 
Seat 4: Alfi_lg7 ($2.09 in chips) 
Seat 6: ZOLOTO- XAXA ($2 in chips) 
OtB_PeruVian will be allowed to play after the button
ZOLOTO- XAXA: posts small blind $0.01
pedroabreu1: posts big blind $0.02
*** HOLE CARDS ***
Dealt to pedroabreu1 [5c 8h]
maslovaMKV: calls $0.02
bashbull: folds 
Alfi_lg7: folds 
ZOLOTO- XAXA: folds 
pedroabreu1: checks 
*** FLOP *** [5s 6d Ah]
pedroabreu1: checks 
maslovaMKV: bets $0.05
pedroabreu1: folds 
Uncalled bet ($0.05) returned to maslovaMKV
maslovaMKV collected $0.05 from pot
*** SUMMARY ***
Total pot $0.05 | Rake $0 
Board [5s 6d Ah]
Seat 1: pedroabreu1 (big blind) folded on the Flop
Seat 2: maslovaMKV collected ($0.05)
Seat 3: bashbull folded before Flop (didn't bet)
Seat 4: Alfi_lg7 (button) folded before Flop (didn't bet)
Seat 6: ZOLOTO- XAXA (small blind) folded before Flop



PokerStars Hand #164796173444:  Hold'em No Limit ($0.01/$0.02 USD) - 2017/01/18 16:27:30 ET
Table 'Dollfus II' 6-max Seat #6 is the button
Seat 1: pedroabreu1 ($4.48 in chips) 
Seat 2: maslovaMKV ($1.67 in chips) 
Seat 3: bashbull ($2.32 in chips) 
Seat 4: Alfi_lg7 ($2.09 in chips) 
Seat 6: ZOLOTO- XAXA ($2 in chips) 
pedroabreu1: posts small blind $0.01
maslovaMKV: posts big blind $0.02
OtB_PeruVian: sits out 
*** HOLE CARDS ***
Dealt to pedroabreu1 [Ad 3h]
bashbull: folds 
Alfi_lg7: folds 
ZOLOTO- XAXA: folds 
pedroabreu1: folds 
Uncalled bet ($0.01) returned to maslovaMKV
maslovaMKV collected $0.02 from pot
*** SUMMARY ***
Total pot $0.02 | Rake $0 
Seat 1: pedroabreu1 (small blind) folded before Flop
Seat 2: maslovaMKV (big blind) collected ($0.02)
Seat 3: bashbull folded before Flop (didn't bet)
Seat 4: Alfi_lg7 folded before Flop (didn't bet)
Seat 6: ZOLOTO- XAXA (button) folded before Flop (didn't bet)



PokerStars Hand #164796200060:  Hold'em No Limit ($0.01/$0.02 USD) - 2017/01/18 16:27:57 ET
Table 'Dollfus II' 6-max Seat #1 is the button
Seat 1: pedroabreu1 ($4.47 in chips) 
Seat 2: maslovaMKV ($1.68 in chips) 
Seat 4: Alfi_lg7 ($2.09 in chips) 
Seat 6: ZOLOTO- XAXA ($2 in chips) 
maslovaMKV: posts small blind $0.01
bashbull: is sitting out 
bashbull leaves the table
Alfi_lg7: posts big blind $0.02
OtB_PeruVian: sits out 
*** HOLE CARDS ***
Dealt to pedroabreu1 [6h Jd]
pantelgr joins the table at seat #3 
ZOLOTO- XAXA: folds 
pedroabreu1: folds 
maslovaMKV: calls $0.01
Alfi_lg7: checks 
*** FLOP *** [9h 7h 6d]
maslovaMKV: checks 
Alfi_lg7: bets $0.04
maslovaMKV: folds 
Uncalled bet ($0.04) returned to Alfi_lg7
Alfi_lg7 collected $0.04 from pot
Alfi_lg7: doesn't show hand 
*** SUMMARY ***
Total pot $0.04 | Rake $0 
Board [9h 7h 6d]
Seat 1: pedroabreu1 (button) folded before Flop (didn't bet)
Seat 2: maslovaMKV (small blind) folded on the Flop
Seat 4: Alfi_lg7 (big blind) collected ($0.04)
Seat 6: ZOLOTO- XAXA folded before Flop (didn't bet)



PokerStars Hand #164796233330:  Hold'em No Limit ($0.01/$0.02 USD) - 2017/01/18 16:28:31 ET
Table 'Dollfus II' 6-max Seat #2 is the button
Seat 1: pedroabreu1 ($4.47 in chips) 
Seat 2: maslovaMKV ($1.66 in chips) 
Seat 4: Alfi_lg7 ($2.11 in chips) 
Seat 5: OtB_PeruVian ($2 in chips) 
Seat 6: ZOLOTO- XAXA ($2 in chips) 
pantelgr will be allowed to play after the button
Alfi_lg7: posts small blind $0.01
OtB_PeruVian: posts big blind $0.02
*** HOLE CARDS ***
Dealt to pedroabreu1 [5d 6c]
ZOLOTO- XAXA: folds 
pedroabreu1: folds 
maslovaMKV: folds 
Alfi_lg7: raises $0.08 to $0.10
OtB_PeruVian: folds 
Uncalled bet ($0.08) returned to Alfi_lg7
Alfi_lg7 collected $0.04 from pot
Alfi_lg7: doesn't show hand 
*** SUMMARY ***
Total pot $0.04 | Rake $0 
Seat 1: pedroabreu1 folded before Flop (didn't bet)
Seat 2: maslovaMKV (button) folded before Flop (didn't bet)
Seat 4: Alfi_lg7 (small blind) collected ($0.04)
Seat 5: OtB_PeruVian (big blind) folded before Flop
Seat 6: ZOLOTO- XAXA folded before Flop (didn't bet)



PokerStars Hand #164796256456:  Hold'em No Limit ($0.01/$0.02 USD) - 2017/01/18 16:28:54 ET
Table 'Dollfus II' 6-max Seat #4 is the button
Seat 1: pedroabreu1 ($4.47 in chips) 
Seat 2: maslovaMKV ($1.66 in chips) 
Seat 4: Alfi_lg7 ($2.13 in chips) 
Seat 5: OtB_PeruVian ($2 in chips) 
Seat 6: ZOLOTO- XAXA ($2 in chips) 
OtB_PeruVian: posts small blind $0.01
ZOLOTO- XAXA: posts big blind $0.02
pantelgr: sits out 
*** HOLE CARDS ***
Dealt to pedroabreu1 [Ac Qd]
pedroabreu1: raises $0.04 to $0.06
maslovaMKV: folds 
Alfi_lg7: folds 
OtB_PeruVian: folds 
ZOLOTO- XAXA: calls $0.04
*** FLOP *** [7d Qs 7c]
ZOLOTO- XAXA: checks 
pedroabreu1: bets $0.08
ZOLOTO- XAXA: folds 
Uncalled bet ($0.08) returned to pedroabreu1
pedroabreu1 collected $0.13 from pot
pedroabreu1: doesn't show hand 
*** SUMMARY ***
Total pot $0.13 | Rake $0 
Board [7d Qs 7c]
Seat 1: pedroabreu1 collected ($0.13)
Seat 2: maslovaMKV folded before Flop (didn't bet)
Seat 4: Alfi_lg7 (button) folded before Flop (didn't bet)
Seat 5: OtB_PeruVian (small blind) folded before Flop
Seat 6: ZOLOTO- XAXA (big blind) folded on the Flop



PokerStars Hand #164796293413:  Hold'em No Limit ($0.01/$0.02 USD) - 2017/01/18 16:29:32 ET
Table 'Dollfus II' 6-max Seat #5 is the button
Seat 1: pedroabreu1 ($4.54 in chips) 
Seat 2: maslovaMKV ($1.66 in chips) 
Seat 4: Alfi_lg7 ($2.13 in chips) 
Seat 5: OtB_PeruVian ($2 in chips) 
Seat 6: ZOLOTO- XAXA ($2 in chips) 
ZOLOTO- XAXA: posts small blind $0.01
pedroabreu1: posts big blind $0.02
pantelgr: sits out 
*** HOLE CARDS ***
Dealt to pedroabreu1 [4c Jh]
maslovaMKV: folds 
Alfi_lg7: folds 
OtB_PeruVian: folds 
ZOLOTO- XAXA: raises $0.04 to $0.06
pedroabreu1: folds 
Uncalled bet ($0.04) returned to ZOLOTO- XAXA
ZOLOTO- XAXA collected $0.04 from pot
*** SUMMARY ***
Total pot $0.04 | Rake $0 
Seat 1: pedroabreu1 (big blind) folded before Flop
Seat 2: maslovaMKV folded before Flop (didn't bet)
Seat 4: Alfi_lg7 folded before Flop (didn't bet)
Seat 5: OtB_PeruVian (button) folded before Flop (didn't bet)
Seat 6: ZOLOTO- XAXA (small blind) collected ($0.04)



PokerStars Hand #164796317444:  Hold'em No Limit ($0.01/$0.02 USD) - 2017/01/18 16:29:57 ET
Table 'Dollfus II' 6-max Seat #6 is the button
Seat 1: pedroabreu1 ($4.52 in chips) 
Seat 2: maslovaMKV ($1.66 in chips) 
Seat 4: Alfi_lg7 ($2.13 in chips) 
Seat 5: OtB_PeruVian ($2 in chips) 
Seat 6: ZOLOTO- XAXA ($2.02 in chips) 
pedroabreu1: posts small blind $0.01
maslovaMKV: posts big blind $0.02
pantelgr: sits out 
*** HOLE CARDS ***
Dealt to pedroabreu1 [4h Ac]
Alfi_lg7: raises $0.06 to $0.08
OtB_PeruVian: folds 
ZOLOTO- XAXA: calls $0.08
pedroabreu1: folds 
maslovaMKV: folds 
*** FLOP *** [Qh Kh Qc]
Alfi_lg7: checks 
ZOLOTO- XAXA: checks 
*** TURN *** [Qh Kh Qc] [7h]
Alfi_lg7: checks 
ZOLOTO- XAXA: checks 
*** RIVER *** [Qh Kh Qc 7h] [Td]
Alfi_lg7: checks 
ZOLOTO- XAXA: checks 
*** SHOW DOWN ***
Alfi_lg7: shows [5c 5d] (two pair, Queens and Fives)
ZOLOTO- XAXA: shows [6h 6c] (two pair, Queens and Sixes)
ZOLOTO- XAXA collected $0.18 from pot
*** SUMMARY ***
Total pot $0.19 | Rake $0.01 
Board [Qh Kh Qc 7h Td]
Seat 1: pedroabreu1 (small blind) folded before Flop
Seat 2: maslovaMKV (big blind) folded before Flop
Seat 4: Alfi_lg7 showed [5c 5d] and lost with two pair, Queens and Fives
Seat 5: OtB_PeruVian folded before Flop (didn't bet)
Seat 6: ZOLOTO- XAXA (button) showed [6h 6c] and won ($0.18) with two pair, Queens and Sixes



PokerStars Hand #164796351420:  Hold'em No Limit ($0.01/$0.02 USD) - 2017/01/18 16:30:31 ET
Table 'Dollfus II' 6-max Seat #1 is the button
Seat 1: pedroabreu1 ($4.51 in chips) 
Seat 2: maslovaMKV ($1.64 in chips) 
Seat 3: pantelgr ($2 in chips) 
Seat 4: Alfi_lg7 ($2.05 in chips) 
Seat 5: OtB_PeruVian ($2 in chips) 
Seat 6: ZOLOTO- XAXA ($2.12 in chips) 
maslovaMKV: posts small blind $0.01
pantelgr: posts big blind $0.02
*** HOLE CARDS ***
Dealt to pedroabreu1 [Ac 7s]
Alfi_lg7: folds 
OtB_PeruVian: folds 
ZOLOTO- XAXA: raises $0.04 to $0.06
pedroabreu1: folds 
maslovaMKV: folds 
pantelgr: folds 
Uncalled bet ($0.04) returned to ZOLOTO- XAXA
ZOLOTO- XAXA collected $0.05 from pot
ZOLOTO- XAXA: doesn't show hand 
*** SUMMARY ***
Total pot $0.05 | Rake $0 
Seat 1: pedroabreu1 (button) folded before Flop (didn't bet)
Seat 2: maslovaMKV (small blind) folded before Flop
Seat 3: pantelgr (big blind) folded before Flop
Seat 4: Alfi_lg7 folded before Flop (didn't bet)
Seat 5: OtB_PeruVian folded before Flop (didn't bet)
Seat 6: ZOLOTO- XAXA collected ($0.05)



PokerStars Hand #164796374559:  Hold'em No Limit ($0.01/$0.02 USD) - 2017/01/18 16:30:54 ET
Table 'Dollfus II' 6-max Seat #2 is the button
Seat 1: pedroabreu1 ($4.51 in chips) 
Seat 2: maslovaMKV ($1.63 in chips) 
Seat 3: pantelgr ($2 in chips) 
Seat 4: Alfi_lg7 ($2.05 in chips) 
Seat 5: OtB_PeruVian ($2 in chips) 
Seat 6: ZOLOTO- XAXA ($2.15 in chips) 
pantelgr: posts small blind $0.01
Alfi_lg7: posts big blind $0.02
*** HOLE CARDS ***
Dealt to pedroabreu1 [6h 4s]
OtB_PeruVian: folds 
ZOLOTO- XAXA: folds 
pedroabreu1: folds 
maslovaMKV: folds 
pantelgr: raises $0.04 to $0.06
Alfi_lg7: folds 
Uncalled bet ($0.04) returned to pantelgr
pantelgr collected $0.04 from pot
pantelgr: doesn't show hand 
*** SUMMARY ***
Total pot $0.04 | Rake $0 
Seat 1: pedroabreu1 folded before Flop (didn't bet)
Seat 2: maslovaMKV (button) folded before Flop (didn't bet)
Seat 3: pantelgr (small blind) collected ($0.04)
Seat 4: Alfi_lg7 (big blind) folded before Flop
Seat 5: OtB_PeruVian folded before Flop (didn't bet)
Seat 6: ZOLOTO- XAXA folded before Flop (didn't bet)



PokerStars Hand #164796400395:  Hold'em No Limit ($0.01/$0.02 USD) - 2017/01/18 16:31:20 ET
Table 'Dollfus II' 6-max Seat #3 is the button
Seat 1: pedroabreu1 ($4.51 in chips) 
Seat 2: maslovaMKV ($1.63 in chips) 
Seat 3: pantelgr ($2.02 in chips) 
Seat 4: Alfi_lg7 ($2.03 in chips) 
Seat 5: OtB_PeruVian ($2 in chips) 
Seat 6: ZOLOTO- XAXA ($2.15 in chips) 
Alfi_lg7: posts small blind $0.01
OtB_PeruVian: posts big blind $0.02
*** HOLE CARDS ***
Dealt to pedroabreu1 [Ts Jh]
ZOLOTO- XAXA: folds 
pedroabreu1: calls $0.02
maslovaMKV: folds 
pantelgr: folds 
Alfi_lg7: folds 
OtB_PeruVian: checks 
*** FLOP *** [4h 9c 6d]
OtB_PeruVian: checks 
pedroabreu1: bets $0.05
OtB_PeruVian: folds 
Uncalled bet ($0.05) returned to pedroabreu1
pedroabreu1 collected $0.05 from pot
pedroabreu1: doesn't show hand 
*** SUMMARY ***
Total pot $0.05 | Rake $0 
Board [4h 9c 6d]
Seat 1: pedroabreu1 collected ($0.05)
Seat 2: maslovaMKV folded before Flop (didn't bet)
Seat 3: pantelgr (button) folded before Flop (didn't bet)
Seat 4: Alfi_lg7 (small blind) folded before Flop
Seat 5: OtB_PeruVian (big blind) folded on the Flop
Seat 6: ZOLOTO- XAXA folded before Flop (didn't bet)



PokerStars Hand #164796440574:  Hold'em No Limit ($0.01/$0.02 USD) - 2017/01/18 16:32:01 ET
Table 'Dollfus II' 6-max Seat #4 is the button
Seat 1: pedroabreu1 ($4.54 in chips) 
Seat 2: maslovaMKV ($1.63 in chips) 
Seat 3: pantelgr ($2.02 in chips) 
Seat 4: Alfi_lg7 ($2.02 in chips) 
Seat 5: OtB_PeruVian ($2 in chips) 
Seat 6: ZOLOTO- XAXA ($2.15 in chips) 
OtB_PeruVian: posts small blind $0.01
ZOLOTO- XAXA: posts big blind $0.02
*** HOLE CARDS ***
Dealt to pedroabreu1 [2d 5c]
pedroabreu1: folds 
maslovaMKV: folds 
pantelgr: raises $0.04 to $0.06
Alfi_lg7: folds 
OtB_PeruVian: folds 
ZOLOTO- XAXA: folds 
Uncalled bet ($0.04) returned to pantelgr
pantelgr collected $0.05 from pot
pantelgr: doesn't show hand 
*** SUMMARY ***
Total pot $0.05 | Rake $0 
Seat 1: pedroabreu1 folded before Flop (didn't bet)
Seat 2: maslovaMKV folded before Flop (didn't bet)
Seat 3: pantelgr collected ($0.05)
Seat 4: Alfi_lg7 (button) folded before Flop (didn't bet)
Seat 5: OtB_PeruVian (small blind) folded before Flop
Seat 6: ZOLOTO- XAXA (big blind) folded before Flop



PokerStars Hand #164796464987:  Hold'em No Limit ($0.01/$0.02 USD) - 2017/01/18 16:32:26 ET
Table 'Dollfus II' 6-max Seat #5 is the button
Seat 1: pedroabreu1 ($4.54 in chips) 
Seat 2: maslovaMKV ($1.63 in chips) 
Seat 3: pantelgr ($2.05 in chips) 
Seat 4: Alfi_lg7 ($2.02 in chips) 
Seat 5: OtB_PeruVian ($2 in chips) 
Seat 6: ZOLOTO- XAXA ($2.13 in chips) 
ZOLOTO- XAXA: posts small blind $0.01
pedroabreu1: posts big blind $0.02
*** HOLE CARDS ***
Dealt to pedroabreu1 [2h As]
maslovaMKV: calls $0.02
pantelgr: folds 
Alfi_lg7: folds 
OtB_PeruVian: folds 
ZOLOTO- XAXA: folds 
pedroabreu1: checks 
*** FLOP *** [3h 9c 5s]
pedroabreu1: checks 
maslovaMKV: checks 
*** TURN *** [3h 9c 5s] [9h]
pedroabreu1: bets $0.05
maslovaMKV: calls $0.05
*** RIVER *** [3h 9c 5s 9h] [Qd]
pedroabreu1: checks 
maslovaMKV: bets $0.14
pedroabreu1: folds 
Uncalled bet ($0.14) returned to maslovaMKV
maslovaMKV collected $0.14 from pot
*** SUMMARY ***
Total pot $0.15 | Rake $0.01 
Board [3h 9c 5s 9h Qd]
Seat 1: pedroabreu1 (big blind) folded on the River
Seat 2: maslovaMKV collected ($0.14)
Seat 3: pantelgr folded before Flop (didn't bet)
Seat 4: Alfi_lg7 folded before Flop (didn't bet)
Seat 5: OtB_PeruVian (button) folded before Flop (didn't bet)
Seat 6: ZOLOTO- XAXA (small blind) folded before Flop



PokerStars Hand #164796515253:  Hold'em No Limit ($0.01/$0.02 USD) - 2017/01/18 16:33:17 ET
Table 'Dollfus II' 6-max Seat #6 is the button
Seat 1: pedroabreu1 ($4.47 in chips) 
Seat 2: maslovaMKV ($1.70 in chips) 
Seat 3: pantelgr ($2.05 in chips) 
Seat 4: Alfi_lg7 ($2.02 in chips) 
Seat 5: OtB_PeruVian ($2 in chips) 
Seat 6: ZOLOTO- XAXA ($2.12 in chips) 
pedroabreu1: posts small blind $0.01
maslovaMKV: posts big blind $0.02
*** HOLE CARDS ***
Dealt to pedroabreu1 [Ad 6d]
pantelgr: folds 
Alfi_lg7: folds 
OtB_PeruVian: folds 
ZOLOTO- XAXA: folds 
pedroabreu1: raises $0.04 to $0.06
maslovaMKV: folds 
Uncalled bet ($0.04) returned to pedroabreu1
pedroabreu1 collected $0.04 from pot
pedroabreu1: doesn't show hand 
*** SUMMARY ***
Total pot $0.04 | Rake $0 
Seat 1: pedroabreu1 (small blind) collected ($0.04)
Seat 2: maslovaMKV (big blind) folded before Flop
Seat 3: pantelgr folded before Flop (didn't bet)
Seat 4: Alfi_lg7 folded before Flop (didn't bet)
Seat 5: OtB_PeruVian folded before Flop (didn't bet)
Seat 6: ZOLOTO- XAXA (button) folded before Flop (didn't bet)



PokerStars Hand #164796542335:  Hold'em No Limit ($0.01/$0.02 USD) - 2017/01/18 16:33:45 ET
Table 'Dollfus II' 6-max Seat #1 is the button
Seat 1: pedroabreu1 ($4.49 in chips) 
Seat 2: maslovaMKV ($1.68 in chips) 
Seat 3: pantelgr ($2.05 in chips) 
Seat 4: Alfi_lg7 ($2.02 in chips) 
Seat 5: OtB_PeruVian ($2 in chips) 
Seat 6: ZOLOTO- XAXA ($2.12 in chips) 
maslovaMKV: posts small blind $0.01
pantelgr: posts big blind $0.02
*** HOLE CARDS ***
Dealt to pedroabreu1 [Kh Qd]
Alfi_lg7: folds 
OtB_PeruVian: folds 
ZOLOTO- XAXA: raises $0.04 to $0.06
pedroabreu1: raises $0.15 to $0.21
maslovaMKV: folds 
pantelgr: folds 
ZOLOTO- XAXA: folds 
Uncalled bet ($0.15) returned to pedroabreu1
pedroabreu1 collected $0.15 from pot
pedroabreu1: doesn't show hand 
*** SUMMARY ***
Total pot $0.15 | Rake $0 
Seat 1: pedroabreu1 (button) collected ($0.15)
Seat 2: maslovaMKV (small blind) folded before Flop
Seat 3: pantelgr (big blind) folded before Flop
Seat 4: Alfi_lg7 folded before Flop (didn't bet)
Seat 5: OtB_PeruVian folded before Flop (didn't bet)
Seat 6: ZOLOTO- XAXA folded before Flop



PokerStars Hand #164796577392:  Hold'em No Limit ($0.01/$0.02 USD) - 2017/01/18 16:34:20 ET
Table 'Dollfus II' 6-max Seat #2 is the button
Seat 1: pedroabreu1 ($4.58 in chips) 
Seat 2: maslovaMKV ($1.67 in chips) 
Seat 3: pantelgr ($2.03 in chips) 
Seat 5: OtB_PeruVian ($2 in chips) 
Seat 6: ZOLOTO- XAXA ($2.06 in chips) 
pantelgr: posts small blind $0.01
Alfi_lg7: is sitting out 
Alfi_lg7 leaves the table
OtB_PeruVian: posts big blind $0.02
*** HOLE CARDS ***
Dealt to pedroabreu1 [4h 9s]
ZOLOTO- XAXA: folds 
pedroabreu1: folds 
maslovaMKV: folds 
pantelgr: folds 
Uncalled bet ($0.01) returned to OtB_PeruVian
OtB_PeruVian collected $0.02 from pot
OtB_PeruVian: doesn't show hand 
*** SUMMARY ***
Total pot $0.02 | Rake $0 
Seat 1: pedroabreu1 folded before Flop (didn't bet)
Seat 2: maslovaMKV (button) folded before Flop (didn't bet)
Seat 3: pantelgr (small blind) folded before Flop
Seat 5: OtB_PeruVian (big blind) collected ($0.02)
Seat 6: ZOLOTO- XAXA folded before Flop (didn't bet)



PokerStars Hand #164796587973:  Hold'em No Limit ($0.01/$0.02 USD) - 2017/01/18 16:34:31 ET
Table 'Dollfus II' 6-max Seat #3 is the button
Seat 1: pedroabreu1 ($4.58 in chips) 
Seat 2: maslovaMKV ($1.67 in chips) 
Seat 3: pantelgr ($2.02 in chips) 
Seat 5: OtB_PeruVian ($2.01 in chips) 
Seat 6: ZOLOTO- XAXA ($2.06 in chips) 
OtB_PeruVian: posts small blind $0.01
ZOLOTO- XAXA: posts big blind $0.02
*** HOLE CARDS ***
Dealt to pedroabreu1 [4d 6s]
pedroabreu1: folds 
maslovaMKV: folds 
pantelgr: raises $0.03 to $0.05
OtB_PeruVian: folds 
ZOLOTO- XAXA: folds 
Uncalled bet ($0.03) returned to pantelgr
pantelgr collected $0.05 from pot
pantelgr: doesn't show hand 
*** SUMMARY ***
Total pot $0.05 | Rake $0 
Seat 1: pedroabreu1 folded before Flop (didn't bet)
Seat 2: maslovaMKV folded before Flop (didn't bet)
Seat 3: pantelgr (button) collected ($0.05)
Seat 5: OtB_PeruVian (small blind) folded before Flop
Seat 6: ZOLOTO- XAXA (big blind) folded before Flop



PokerStars Hand #164796616452:  Hold'em No Limit ($0.01/$0.02 USD) - 2017/01/18 16:35:00 ET
Table 'Dollfus II' 6-max Seat #5 is the button
Seat 1: pedroabreu1 ($4.58 in chips) 
Seat 2: maslovaMKV ($1.67 in chips) 
Seat 3: pantelgr ($2.05 in chips) 
Seat 5: OtB_PeruVian ($2 in chips) 
Seat 6: ZOLOTO- XAXA ($2.04 in chips) 
ZOLOTO- XAXA: posts small blind $0.01
pedroabreu1: posts big blind $0.02
*** HOLE CARDS ***
Dealt to pedroabreu1 [7h Kh]
maslovaMKV: folds 
pantelgr: folds 
OtB_PeruVian: folds 
ZOLOTO- XAXA: folds 
Uncalled bet ($0.01) returned to pedroabreu1
pedroabreu1 collected $0.02 from pot
pedroabreu1: doesn't show hand 
*** SUMMARY ***
Total pot $0.02 | Rake $0 
Seat 1: pedroabreu1 (big blind) collected ($0.02)
Seat 2: maslovaMKV folded before Flop (didn't bet)
Seat 3: pantelgr folded before Flop (didn't bet)
Seat 5: OtB_PeruVian (button) folded before Flop (didn't bet)
Seat 6: ZOLOTO- XAXA (small blind) folded before Flop



PokerStars Hand #164796638109:  Hold'em No Limit ($0.01/$0.02 USD) - 2017/01/18 16:35:22 ET
Table 'Dollfus II' 6-max Seat #6 is the button
Seat 1: pedroabreu1 ($4.59 in chips) 
Seat 2: maslovaMKV ($1.67 in chips) 
Seat 3: pantelgr ($2.05 in chips) 
Seat 5: OtB_PeruVian ($2 in chips) 
Seat 6: ZOLOTO- XAXA ($2.03 in chips) 
pedroabreu1: posts small blind $0.01
maslovaMKV: posts big blind $0.02
*** HOLE CARDS ***
Dealt to pedroabreu1 [5h 7d]
pantelgr: folds 
OtB_PeruVian: folds 
ZOLOTO- XAXA: folds 
pedroabreu1: folds 
Uncalled bet ($0.01) returned to maslovaMKV
maslovaMKV collected $0.02 from pot
*** SUMMARY ***
Total pot $0.02 | Rake $0 
Seat 1: pedroabreu1 (small blind) folded before Flop
Seat 2: maslovaMKV (big blind) collected ($0.02)
Seat 3: pantelgr folded before Flop (didn't bet)
Seat 5: OtB_PeruVian folded before Flop (didn't bet)
Seat 6: ZOLOTO- XAXA (button) folded before Flop (didn't bet)



PokerStars Hand #164796647681:  Hold'em No Limit ($0.01/$0.02 USD) - 2017/01/18 16:35:32 ET
Table 'Dollfus II' 6-max Seat #1 is the button
Seat 1: pedroabreu1 ($4.58 in chips) 
Seat 2: maslovaMKV ($1.68 in chips) 
Seat 3: pantelgr ($2.05 in chips) 
Seat 5: OtB_PeruVian ($2 in chips) 
Seat 6: ZOLOTO- XAXA ($2.03 in chips) 
maslovaMKV: posts small blind $0.01
pantelgr: posts big blind $0.02
*** HOLE CARDS ***
Dealt to pedroabreu1 [9c 7c]
OtB_PeruVian: folds 
ZOLOTO- XAXA: folds 
pedroabreu1: raises $0.04 to $0.06
maslovaMKV: folds 
pantelgr: folds 
Uncalled bet ($0.04) returned to pedroabreu1
pedroabreu1 collected $0.05 from pot
pedroabreu1: doesn't show hand 
*** SUMMARY ***
Total pot $0.05 | Rake $0 
Seat 1: pedroabreu1 (button) collected ($0.05)
Seat 2: maslovaMKV (small blind) folded before Flop
Seat 3: pantelgr (big blind) folded before Flop
Seat 5: OtB_PeruVian folded before Flop (didn't bet)
Seat 6: ZOLOTO- XAXA folded before Flop (didn't bet)



PokerStars Hand #164796660744:  Hold'em No Limit ($0.01/$0.02 USD) - 2017/01/18 16:35:45 ET
Table 'Dollfus II' 6-max Seat #2 is the button
Seat 1: pedroabreu1 ($4.61 in chips) 
Seat 2: maslovaMKV ($1.67 in chips) 
Seat 3: pantelgr ($2.03 in chips) 
Seat 5: OtB_PeruVian ($2 in chips) 
Seat 6: ZOLOTO- XAXA ($2.03 in chips) 
pantelgr: posts small blind $0.01
OtB_PeruVian: posts big blind $0.02
*** HOLE CARDS ***
Dealt to pedroabreu1 [Tc Jh]
ZOLOTO- XAXA: folds 
pedroabreu1: raises $0.04 to $0.06
maslovaMKV: folds 
pantelgr: folds 
OtB_PeruVian: calls $0.04
*** FLOP *** [Kd Ah Qh]
OtB_PeruVian: checks 
pedroabreu1: checks 
*** TURN *** [Kd Ah Qh] [Ks]
OtB_PeruVian: checks 
pedroabreu1: bets $0.08
OtB_PeruVian: folds 
Uncalled bet ($0.08) returned to pedroabreu1
pedroabreu1 collected $0.13 from pot
pedroabreu1: doesn't show hand 
*** SUMMARY ***
Total pot $0.13 | Rake $0 
Board [Kd Ah Qh Ks]
Seat 1: pedroabreu1 collected ($0.13)
Seat 2: maslovaMKV (button) folded before Flop (didn't bet)
Seat 3: pantelgr (small blind) folded before Flop
Seat 5: OtB_PeruVian (big blind) folded on the Turn
Seat 6: ZOLOTO- XAXA folded before Flop (didn't bet)



PokerStars Hand #164796714149:  Hold'em No Limit ($0.01/$0.02 USD) - 2017/01/18 16:36:40 ET
Table 'Dollfus II' 6-max Seat #3 is the button
Seat 1: pedroabreu1 ($4.68 in chips) 
Seat 2: maslovaMKV ($1.67 in chips) 
Seat 3: pantelgr ($2.02 in chips) 
Seat 5: OtB_PeruVian ($2 in chips) 
Seat 6: ZOLOTO- XAXA ($2.03 in chips) 
OtB_PeruVian: posts small blind $0.01
ZOLOTO- XAXA: posts big blind $0.02
*** HOLE CARDS ***
Dealt to pedroabreu1 [6c Tc]
pedroabreu1: folds 
maslovaMKV: folds 
pantelgr: folds 
OtB_PeruVian: folds 
Uncalled bet ($0.01) returned to ZOLOTO- XAXA
ZOLOTO- XAXA collected $0.02 from pot
ZOLOTO- XAXA: doesn't show hand 
*** SUMMARY ***
Total pot $0.02 | Rake $0 
Seat 1: pedroabreu1 folded before Flop (didn't bet)
Seat 2: maslovaMKV folded before Flop (didn't bet)
Seat 3: pantelgr (button) folded before Flop (didn't bet)
Seat 5: OtB_PeruVian (small blind) folded before Flop
Seat 6: ZOLOTO- XAXA (big blind) collected ($0.02)



PokerStars Hand #164796730794:  Hold'em No Limit ($0.01/$0.02 USD) - 2017/01/18 16:36:57 ET
Table 'Dollfus II' 6-max Seat #5 is the button
Seat 1: pedroabreu1 ($4.68 in chips) 
Seat 2: maslovaMKV ($1.67 in chips) 
Seat 3: pantelgr ($2.02 in chips) 
Seat 5: OtB_PeruVian ($2 in chips) 
Seat 6: ZOLOTO- XAXA ($2.04 in chips) 
ZOLOTO- XAXA: posts small blind $0.01
pedroabreu1: posts big blind $0.02
*** HOLE CARDS ***
Dealt to pedroabreu1 [3s 7h]
maslovaMKV: folds 
pantelgr: folds 
abe_south joins the table at seat #4 
OtB_PeruVian: folds 
ZOLOTO- XAXA: folds 
Uncalled bet ($0.01) returned to pedroabreu1
pedroabreu1 collected $0.02 from pot
pedroabreu1: doesn't show hand 
*** SUMMARY ***
Total pot $0.02 | Rake $0 
Seat 1: pedroabreu1 (big blind) collected ($0.02)
Seat 2: maslovaMKV folded before Flop (didn't bet)
Seat 3: pantelgr folded before Flop (didn't bet)
Seat 5: OtB_PeruVian (button) folded before Flop (didn't bet)
Seat 6: ZOLOTO- XAXA (small blind) folded before Flop



PokerStars Hand #164796748684:  Hold'em No Limit ($0.01/$0.02 USD) - 2017/01/18 16:37:15 ET
Table 'Dollfus II' 6-max Seat #6 is the button
Seat 1: pedroabreu1 ($4.69 in chips) 
Seat 2: maslovaMKV ($1.67 in chips) 
Seat 3: pantelgr ($2.02 in chips) 
Seat 5: OtB_PeruVian ($2 in chips) 
Seat 6: ZOLOTO- XAXA ($2.03 in chips) 
pedroabreu1: posts small blind $0.01
maslovaMKV: posts big blind $0.02
abe_south: sits out 
*** HOLE CARDS ***
Dealt to pedroabreu1 [8h Jd]
pantelgr: folds 
abe_south leaves the table
OtB_PeruVian: folds 
ZOLOTO- XAXA: raises $0.04 to $0.06
pedroabreu1: folds 
maslovaMKV: folds 
Uncalled bet ($0.04) returned to ZOLOTO- XAXA
ZOLOTO- XAXA collected $0.05 from pot
ZOLOTO- XAXA: doesn't show hand 
*** SUMMARY ***
Total pot $0.05 | Rake $0 
Seat 1: pedroabreu1 (small blind) folded before Flop
Seat 2: maslovaMKV (big blind) folded before Flop
Seat 3: pantelgr folded before Flop (didn't bet)
Seat 5: OtB_PeruVian folded before Flop (didn't bet)
Seat 6: ZOLOTO- XAXA (button) collected ($0.05)



PokerStars Hand #164796773767:  Hold'em No Limit ($0.01/$0.02 USD) - 2017/01/18 16:37:41 ET
Table 'Dollfus II' 6-max Seat #1 is the button
Seat 1: pedroabreu1 ($4.68 in chips) 
Seat 2: maslovaMKV ($1.65 in chips) 
Seat 3: pantelgr ($2.02 in chips) 
Seat 5: OtB_PeruVian ($2 in chips) 
Seat 6: ZOLOTO- XAXA ($2.06 in chips) 
maslovaMKV: posts small blind $0.01
pantelgr: posts big blind $0.02
*** HOLE CARDS ***
Dealt to pedroabreu1 [Kh 8s]
kakah_sc joins the table at seat #4 
OtB_PeruVian: folds 
ZOLOTO- XAXA: folds 
pedroabreu1: folds 
maslovaMKV: folds 
Uncalled bet ($0.01) returned to pantelgr
pantelgr collected $0.02 from pot
pantelgr: doesn't show hand 
*** SUMMARY ***
Total pot $0.02 | Rake $0 
Seat 1: pedroabreu1 (button) folded before Flop (didn't bet)
Seat 2: maslovaMKV (small blind) folded before Flop
Seat 3: pantelgr (big blind) collected ($0.02)
Seat 5: OtB_PeruVian folded before Flop (didn't bet)
Seat 6: ZOLOTO- XAXA folded before Flop (didn't bet)



PokerStars Hand #164796794772:  Hold'em No Limit ($0.01/$0.02 USD) - 2017/01/18 16:38:02 ET
Table 'Dollfus II' 6-max Seat #2 is the button
Seat 1: pedroabreu1 ($4.68 in chips) 
Seat 2: maslovaMKV ($1.64 in chips) 
Seat 3: pantelgr ($2.03 in chips) 
Seat 4: kakah_sc ($0.80 in chips) 
Seat 5: OtB_PeruVian ($2 in chips) 
Seat 6: ZOLOTO- XAXA ($2.06 in chips) 
pantelgr: posts small blind $0.01
kakah_sc: posts big blind $0.02
*** HOLE CARDS ***
Dealt to pedroabreu1 [4s Jh]
OtB_PeruVian: folds 
ZOLOTO- XAXA: folds 
pedroabreu1: folds 
maslovaMKV: folds 
pantelgr: folds 
Uncalled bet ($0.01) returned to kakah_sc
kakah_sc collected $0.02 from pot
kakah_sc: doesn't show hand 
*** SUMMARY ***
Total pot $0.02 | Rake $0 
Seat 1: pedroabreu1 folded before Flop (didn't bet)
Seat 2: maslovaMKV (button) folded before Flop (didn't bet)
Seat 3: pantelgr (small blind) folded before Flop
Seat 4: kakah_sc (big blind) collected ($0.02)
Seat 5: OtB_PeruVian folded before Flop (didn't bet)
Seat 6: ZOLOTO- XAXA folded before Flop (didn't bet)



PokerStars Hand #164796819550:  Hold'em No Limit ($0.01/$0.02 USD) - 2017/01/18 16:38:28 ET
Table 'Dollfus II' 6-max Seat #3 is the button
Seat 1: pedroabreu1 ($4.68 in chips) 
Seat 2: maslovaMKV ($1.64 in chips) 
Seat 3: pantelgr ($2.02 in chips) 
Seat 4: kakah_sc ($0.81 in chips) 
Seat 5: OtB_PeruVian ($2 in chips) 
Seat 6: ZOLOTO- XAXA ($2.06 in chips) 
kakah_sc: posts small blind $0.01
OtB_PeruVian: posts big blind $0.02
*** HOLE CARDS ***
Dealt to pedroabreu1 [Qd 9s]
ZOLOTO- XAXA: folds 
pedroabreu1: folds 
maslovaMKV: folds 
pantelgr: folds 
kakah_sc: calls $0.01
OtB_PeruVian: checks 
*** FLOP *** [Ks Ad 7c]
kakah_sc: bets $0.02
OtB_PeruVian: calls $0.02
*** TURN *** [Ks Ad 7c] [6h]
kakah_sc: bets $0.02
OtB_PeruVian: raises $0.05 to $0.07
kakah_sc: calls $0.05
*** RIVER *** [Ks Ad 7c 6h] [6d]
kakah_sc: bets $0.02
OtB_PeruVian: calls $0.02
*** SHOW DOWN ***
kakah_sc: shows [7s 5h] (two pair, Sevens and Sixes)
OtB_PeruVian: shows [Ah 9h] (two pair, Aces and Sixes)
OtB_PeruVian collected $0.25 from pot
*** SUMMARY ***
Total pot $0.26 | Rake $0.01 
Board [Ks Ad 7c 6h 6d]
Seat 1: pedroabreu1 folded before Flop (didn't bet)
Seat 2: maslovaMKV folded before Flop (didn't bet)
Seat 3: pantelgr (button) folded before Flop (didn't bet)
Seat 4: kakah_sc (small blind) showed [7s 5h] and lost with two pair, Sevens and Sixes
Seat 5: OtB_PeruVian (big blind) showed [Ah 9h] and won ($0.25) with two pair, Aces and Sixes
Seat 6: ZOLOTO- XAXA folded before Flop (didn't bet)



PokerStars Hand #164796875596:  Hold'em No Limit ($0.01/$0.02 USD) - 2017/01/18 16:39:26 ET
Table 'Dollfus II' 6-max Seat #4 is the button
Seat 1: pedroabreu1 ($4.68 in chips) 
Seat 2: maslovaMKV ($1.64 in chips) 
Seat 3: pantelgr ($2.02 in chips) 
Seat 4: kakah_sc ($0.68 in chips) 
Seat 5: OtB_PeruVian ($2.12 in chips) 
Seat 6: ZOLOTO- XAXA ($2.06 in chips) 
OtB_PeruVian: posts small blind $0.01
ZOLOTO- XAXA: posts big blind $0.02
*** HOLE CARDS ***
Dealt to pedroabreu1 [7d Ah]
pedroabreu1: folds 
maslovaMKV: folds 
pantelgr: folds 
kakah_sc: calls $0.02
OtB_PeruVian: folds 
ZOLOTO- XAXA: checks 
*** FLOP *** [5h 4s 2s]
ZOLOTO- XAXA: checks 
kakah_sc: bets $0.02
ZOLOTO- XAXA: folds 
Uncalled bet ($0.02) returned to kakah_sc
kakah_sc collected $0.05 from pot
kakah_sc: doesn't show hand 
*** SUMMARY ***
Total pot $0.05 | Rake $0 
Board [5h 4s 2s]
Seat 1: pedroabreu1 folded before Flop (didn't bet)
Seat 2: maslovaMKV folded before Flop (didn't bet)
Seat 3: pantelgr folded before Flop (didn't bet)
Seat 4: kakah_sc (button) collected ($0.05)
Seat 5: OtB_PeruVian (small blind) folded before Flop
Seat 6: ZOLOTO- XAXA (big blind) folded on the Flop



PokerStars Hand #164796907643:  Hold'em No Limit ($0.01/$0.02 USD) - 2017/01/18 16:39:59 ET
Table 'Dollfus II' 6-max Seat #5 is the button
Seat 1: pedroabreu1 ($4.68 in chips) 
Seat 2: maslovaMKV ($1.64 in chips) 
Seat 3: pantelgr ($2.02 in chips) 
Seat 4: kakah_sc ($0.71 in chips) 
Seat 5: OtB_PeruVian ($2.11 in chips) 
Seat 6: ZOLOTO- XAXA ($2.04 in chips) 
ZOLOTO- XAXA: posts small blind $0.01
pedroabreu1: posts big blind $0.02
*** HOLE CARDS ***
Dealt to pedroabreu1 [Jh 4s]
maslovaMKV: folds 
pantelgr: folds 
kakah_sc: calls $0.02
OtB_PeruVian: folds 
ZOLOTO- XAXA: calls $0.01
pedroabreu1: checks 
*** FLOP *** [9c 3s Kc]
ZOLOTO- XAXA: checks 
pedroabreu1: checks 
kakah_sc: bets $0.04
ZOLOTO- XAXA: folds 
pedroabreu1: folds 
Uncalled bet ($0.04) returned to kakah_sc
kakah_sc collected $0.06 from pot
*** SUMMARY ***
Total pot $0.06 | Rake $0 
Board [9c 3s Kc]
Seat 1: pedroabreu1 (big blind) folded on the Flop
Seat 2: maslovaMKV folded before Flop (didn't bet)
Seat 3: pantelgr folded before Flop (didn't bet)
Seat 4: kakah_sc collected ($0.06)
Seat 5: OtB_PeruVian (button) folded before Flop (didn't bet)
Seat 6: ZOLOTO- XAXA (small blind) folded on the Flop



PokerStars Hand #164796933570:  Hold'em No Limit ($0.01/$0.02 USD) - 2017/01/18 16:40:27 ET
Table 'Dollfus II' 6-max Seat #6 is the button
Seat 1: pedroabreu1 ($4.66 in chips) 
Seat 2: maslovaMKV ($1.64 in chips) 
Seat 3: pantelgr ($2.02 in chips) 
Seat 4: kakah_sc ($0.75 in chips) 
Seat 5: OtB_PeruVian ($2.11 in chips) 
Seat 6: ZOLOTO- XAXA ($2.02 in chips) 
pedroabreu1: posts small blind $0.01
maslovaMKV: posts big blind $0.02
*** HOLE CARDS ***
Dealt to pedroabreu1 [Th 5s]
pantelgr: folds 
kakah_sc: calls $0.02
OtB_PeruVian: raises $0.05 to $0.07
ZOLOTO- XAXA: folds 
pedroabreu1: folds 
maslovaMKV: folds 
kakah_sc: calls $0.05
*** FLOP *** [6c Kc Qh]
kakah_sc: checks 
OtB_PeruVian: checks 
*** TURN *** [6c Kc Qh] [3s]
kakah_sc: bets $0.08
OtB_PeruVian: folds 
Uncalled bet ($0.08) returned to kakah_sc
kakah_sc collected $0.16 from pot
kakah_sc: doesn't show hand 
*** SUMMARY ***
Total pot $0.17 | Rake $0.01 
Board [6c Kc Qh 3s]
Seat 1: pedroabreu1 (small blind) folded before Flop
Seat 2: maslovaMKV (big blind) folded before Flop
Seat 3: pantelgr folded before Flop (didn't bet)
Seat 4: kakah_sc collected ($0.16)
Seat 5: OtB_PeruVian folded on the Turn
Seat 6: ZOLOTO- XAXA (button) folded before Flop (didn't bet)



PokerStars Hand #164796967899:  Hold'em No Limit ($0.01/$0.02 USD) - 2017/01/18 16:41:03 ET
Table 'Dollfus II' 6-max Seat #1 is the button
Seat 1: pedroabreu1 ($4.65 in chips) 
Seat 2: maslovaMKV ($1.62 in chips) 
Seat 3: pantelgr ($2.02 in chips) 
Seat 4: kakah_sc ($0.84 in chips) 
Seat 5: OtB_PeruVian ($2.04 in chips) 
Seat 6: ZOLOTO- XAXA ($2.02 in chips) 
maslovaMKV: posts small blind $0.01
pantelgr: posts big blind $0.02
*** HOLE CARDS ***
Dealt to pedroabreu1 [Jc Kd]
kakah_sc: folds 
OtB_PeruVian: folds 
ZOLOTO- XAXA: folds 
pedroabreu1: raises $0.04 to $0.06
maslovaMKV: folds 
pantelgr: folds 
Uncalled bet ($0.04) returned to pedroabreu1
pedroabreu1 collected $0.05 from pot
pedroabreu1: doesn't show hand 
*** SUMMARY ***
Total pot $0.05 | Rake $0 
Seat 1: pedroabreu1 (button) collected ($0.05)
Seat 2: maslovaMKV (small blind) folded before Flop
Seat 3: pantelgr (big blind) folded before Flop
Seat 4: kakah_sc folded before Flop (didn't bet)
Seat 5: OtB_PeruVian folded before Flop (didn't bet)
Seat 6: ZOLOTO- XAXA folded before Flop (didn't bet)



PokerStars Hand #164796987047:  Hold'em No Limit ($0.01/$0.02 USD) - 2017/01/18 16:41:23 ET
Table 'Dollfus II' 6-max Seat #2 is the button
Seat 1: pedroabreu1 ($4.68 in chips) 
Seat 2: maslovaMKV ($1.61 in chips) 
Seat 3: pantelgr ($2 in chips) 
Seat 4: kakah_sc ($0.84 in chips) 
Seat 5: OtB_PeruVian ($2.04 in chips) 
Seat 6: ZOLOTO- XAXA ($2.02 in chips) 
pantelgr: posts small blind $0.01
kakah_sc: posts big blind $0.02
*** HOLE CARDS ***
Dealt to pedroabreu1 [Ac Td]
OtB_PeruVian: folds 
ZOLOTO- XAXA: folds 
pedroabreu1: raises $0.04 to $0.06
maslovaMKV: calls $0.06
pantelgr: calls $0.05
kakah_sc: folds 
*** FLOP *** [5h Ad 2s]
pantelgr: checks 
pedroabreu1: bets $0.12
maslovaMKV: folds 
pantelgr: folds 
Uncalled bet ($0.12) returned to pedroabreu1
pedroabreu1 collected $0.19 from pot
pedroabreu1: doesn't show hand 
*** SUMMARY ***
Total pot $0.20 | Rake $0.01 
Board [5h Ad 2s]
Seat 1: pedroabreu1 collected ($0.19)
Seat 2: maslovaMKV (button) folded on the Flop
Seat 3: pantelgr (small blind) folded on the Flop
Seat 4: kakah_sc (big blind) folded before Flop
Seat 5: OtB_PeruVian folded before Flop (didn't bet)
Seat 6: ZOLOTO- XAXA folded before Flop (didn't bet)



PokerStars Hand #164797017747:  Hold'em No Limit ($0.01/$0.02 USD) - 2017/01/18 16:41:55 ET
Table 'Dollfus II' 6-max Seat #3 is the button
Seat 1: pedroabreu1 ($4.81 in chips) 
Seat 2: maslovaMKV ($1.55 in chips) 
Seat 3: pantelgr ($2 in chips) 
Seat 4: kakah_sc ($0.82 in chips) 
Seat 5: OtB_PeruVian ($2.04 in chips) 
Seat 6: ZOLOTO- XAXA ($2.02 in chips) 
kakah_sc: posts small blind $0.01
OtB_PeruVian: posts big blind $0.02
*** HOLE CARDS ***
Dealt to pedroabreu1 [7s Qs]
ZOLOTO- XAXA: folds 
pedroabreu1: folds 
maslovaMKV: calls $0.02
pantelgr: raises $0.06 to $0.08
kakah_sc: calls $0.07
OtB_PeruVian: folds 
maslovaMKV: calls $0.06
*** FLOP *** [Jc Ac 2d]
kakah_sc: bets $0.06
maslovaMKV: folds 
pantelgr: calls $0.06
*** TURN *** [Jc Ac 2d] [3c]
kakah_sc: bets $0.06
pantelgr: calls $0.06
*** RIVER *** [Jc Ac 2d 3c] [5s]
kakah_sc: bets $0.62 and is all-in
pantelgr: folds 
Uncalled bet ($0.62) returned to kakah_sc
kakah_sc collected $0.48 from pot
kakah_sc: doesn't show hand 
*** SUMMARY ***
Total pot $0.50 | Rake $0.02 
Board [Jc Ac 2d 3c 5s]
Seat 1: pedroabreu1 folded before Flop (didn't bet)
Seat 2: maslovaMKV folded on the Flop
Seat 3: pantelgr (button) folded on the River
Seat 4: kakah_sc (small blind) collected ($0.48)
Seat 5: OtB_PeruVian (big blind) folded before Flop
Seat 6: ZOLOTO- XAXA folded before Flop (didn't bet)



PokerStars Hand #164797072207:  Hold'em No Limit ($0.01/$0.02 USD) - 2017/01/18 16:42:51 ET
Table 'Dollfus II' 6-max Seat #4 is the button
Seat 1: pedroabreu1 ($4.81 in chips) 
Seat 2: maslovaMKV ($1.50 in chips) 
Seat 3: pantelgr ($2 in chips) 
Seat 4: kakah_sc ($1.10 in chips) 
Seat 5: OtB_PeruVian ($2.02 in chips) 
Seat 6: ZOLOTO- XAXA ($2.02 in chips) 
OtB_PeruVian: posts small blind $0.01
ZOLOTO- XAXA: posts big blind $0.02
*** HOLE CARDS ***
Dealt to pedroabreu1 [3d Th]
pedroabreu1: folds 
maslovaMKV: calls $0.02
pantelgr: raises $0.06 to $0.08
kakah_sc: folds 
OtB_PeruVian: folds 
ZOLOTO- XAXA: folds 
maslovaMKV: calls $0.06
*** FLOP *** [2c 6s Kc]
maslovaMKV: checks 
pantelgr: bets $0.12
maslovaMKV: folds 
Uncalled bet ($0.12) returned to pantelgr
pantelgr collected $0.18 from pot
pantelgr: doesn't show hand 
*** SUMMARY ***
Total pot $0.19 | Rake $0.01 
Board [2c 6s Kc]
Seat 1: pedroabreu1 folded before Flop (didn't bet)
Seat 2: maslovaMKV folded on the Flop
Seat 3: pantelgr collected ($0.18)
Seat 4: kakah_sc (button) folded before Flop (didn't bet)
Seat 5: OtB_PeruVian (small blind) folded before Flop
Seat 6: ZOLOTO- XAXA (big blind) folded before Flop



PokerStars Hand #164797116927:  Hold'em No Limit ($0.01/$0.02 USD) - 2017/01/18 16:43:37 ET
Table 'Dollfus II' 6-max Seat #5 is the button
Seat 1: pedroabreu1 ($4.81 in chips) 
Seat 2: maslovaMKV ($1.50 in chips) 
Seat 3: pantelgr ($2.10 in chips) 
Seat 4: kakah_sc ($1.10 in chips) 
Seat 5: OtB_PeruVian ($2.01 in chips) 
Seat 6: ZOLOTO- XAXA ($2 in chips) 
ZOLOTO- XAXA: posts small blind $0.01
pedroabreu1: posts big blind $0.02
*** HOLE CARDS ***
Dealt to pedroabreu1 [3d Kh]
maslovaMKV: folds 
pantelgr: folds 
kakah_sc: calls $0.02
OtB_PeruVian: folds 
ZOLOTO- XAXA: folds 
pedroabreu1: checks 
*** FLOP *** [7d 9d 9s]
pedroabreu1: checks 
kakah_sc: bets $0.02
pedroabreu1: folds 
Uncalled bet ($0.02) returned to kakah_sc
kakah_sc collected $0.05 from pot
kakah_sc: doesn't show hand 
*** SUMMARY ***
Total pot $0.05 | Rake $0 
Board [7d 9d 9s]
Seat 1: pedroabreu1 (big blind) folded on the Flop
Seat 2: maslovaMKV folded before Flop (didn't bet)
Seat 3: pantelgr folded before Flop (didn't bet)
Seat 4: kakah_sc collected ($0.05)
Seat 5: OtB_PeruVian (button) folded before Flop (didn't bet)
Seat 6: ZOLOTO- XAXA (small blind) folded before Flop



PokerStars Hand #164797158156:  Hold'em No Limit ($0.01/$0.02 USD) - 2017/01/18 16:44:20 ET
Table 'Dollfus II' 6-max Seat #6 is the button
Seat 1: pedroabreu1 ($4.79 in chips) 
Seat 2: maslovaMKV ($1.50 in chips) 
Seat 3: pantelgr ($2.10 in chips) 
Seat 4: kakah_sc ($1.13 in chips) 
Seat 5: OtB_PeruVian ($2.01 in chips) 
Seat 6: ZOLOTO- XAXA ($2 in chips) 
pedroabreu1: posts small blind $0.01
maslovaMKV: posts big blind $0.02
*** HOLE CARDS ***
Dealt to pedroabreu1 [2c 2h]
pantelgr: folds 
kakah_sc: folds 
OtB_PeruVian: folds 
ZOLOTO- XAXA: raises $0.04 to $0.06
pedroabreu1: calls $0.05
maslovaMKV: folds 
*** FLOP *** [7c 5s 7d]
pedroabreu1: checks 
ZOLOTO- XAXA: bets $0.07
pedroabreu1: raises $0.21 to $0.28
ZOLOTO- XAXA: folds 
Uncalled bet ($0.21) returned to pedroabreu1
pedroabreu1 collected $0.27 from pot
pedroabreu1: doesn't show hand 
*** SUMMARY ***
Total pot $0.28 | Rake $0.01 
Board [7c 5s 7d]
Seat 1: pedroabreu1 (small blind) collected ($0.27)
Seat 2: maslovaMKV (big blind) folded before Flop
Seat 3: pantelgr folded before Flop (didn't bet)
Seat 4: kakah_sc folded before Flop (didn't bet)
Seat 5: OtB_PeruVian folded before Flop (didn't bet)
Seat 6: ZOLOTO- XAXA (button) folded on the Flop



PokerStars Hand #164797210215:  Hold'em No Limit ($0.01/$0.02 USD) - 2017/01/18 16:45:14 ET
Table 'Dollfus II' 6-max Seat #1 is the button
Seat 1: pedroabreu1 ($4.93 in chips) 
Seat 2: maslovaMKV ($1.50 in chips) 
Seat 3: pantelgr ($2.10 in chips) 
Seat 4: kakah_sc ($1.13 in chips) 
Seat 5: OtB_PeruVian ($2.01 in chips) 
Seat 6: ZOLOTO- XAXA ($2 in chips) 
maslovaMKV: posts small blind $0.01
pantelgr: posts big blind $0.02
*** HOLE CARDS ***
Dealt to pedroabreu1 [5d Kd]
kakah_sc: calls $0.02
OtB_PeruVian: folds 
ZOLOTO- XAXA: folds 
pedroabreu1: raises $0.06 to $0.08
maslovaMKV: folds 
pantelgr: folds 
kakah_sc: raises $0.06 to $0.14
pedroabreu1: calls $0.06
*** FLOP *** [5c 8s 3s]
kakah_sc: bets $0.02
pedroabreu1: raises $0.18 to $0.20
kakah_sc: calls $0.18
*** TURN *** [5c 8s 3s] [Ks]
kakah_sc: checks 
pedroabreu1: bets $0.35
kakah_sc: folds 
Uncalled bet ($0.35) returned to pedroabreu1
pedroabreu1 collected $0.69 from pot
pedroabreu1: doesn't show hand 
*** SUMMARY ***
Total pot $0.71 | Rake $0.02 
Board [5c 8s 3s Ks]
Seat 1: pedroabreu1 (button) collected ($0.69)
Seat 2: maslovaMKV (small blind) folded before Flop
Seat 3: pantelgr (big blind) folded before Flop
Seat 4: kakah_sc folded on the Turn
Seat 5: OtB_PeruVian folded before Flop (didn't bet)
Seat 6: ZOLOTO- XAXA folded before Flop (didn't bet)



PokerStars Hand #164797268394:  Hold'em No Limit ($0.01/$0.02 USD) - 2017/01/18 16:46:14 ET
Table 'Dollfus II' 6-max Seat #2 is the button
Seat 1: pedroabreu1 ($5.28 in chips) 
Seat 2: maslovaMKV ($1.50 in chips) 
Seat 3: pantelgr ($2.08 in chips) 
Seat 4: kakah_sc ($0.79 in chips) 
Seat 5: OtB_PeruVian ($2.01 in chips) 
Seat 6: ZOLOTO- XAXA ($2 in chips) 
pantelgr: posts small blind $0.01
kakah_sc: posts big blind $0.02
*** HOLE CARDS ***
Dealt to pedroabreu1 [6s 3d]
OtB_PeruVian: folds 
ZOLOTO- XAXA: folds 
pedroabreu1: folds 
maslovaMKV: folds 
pantelgr: raises $0.04 to $0.06
kakah_sc: folds 
Uncalled bet ($0.04) returned to pantelgr
pantelgr collected $0.04 from pot
pantelgr: doesn't show hand 
*** SUMMARY ***
Total pot $0.04 | Rake $0 
Seat 1: pedroabreu1 folded before Flop (didn't bet)
Seat 2: maslovaMKV (button) folded before Flop (didn't bet)
Seat 3: pantelgr (small blind) collected ($0.04)
Seat 4: kakah_sc (big blind) folded before Flop
Seat 5: OtB_PeruVian folded before Flop (didn't bet)
Seat 6: ZOLOTO- XAXA folded before Flop (didn't bet)



PokerStars Hand #164797284504:  Hold'em No Limit ($0.01/$0.02 USD) - 2017/01/18 16:46:31 ET
Table 'Dollfus II' 6-max Seat #3 is the button
Seat 1: pedroabreu1 ($5.28 in chips) 
Seat 2: maslovaMKV ($1.50 in chips) 
Seat 3: pantelgr ($2.10 in chips) 
Seat 4: kakah_sc ($0.77 in chips) 
Seat 5: OtB_PeruVian ($2.01 in chips) 
Seat 6: ZOLOTO- XAXA ($2 in chips) 
kakah_sc: posts small blind $0.01
OtB_PeruVian: posts big blind $0.02
*** HOLE CARDS ***
Dealt to pedroabreu1 [6h 2s]
ZOLOTO- XAXA: folds 
pedroabreu1: folds 
maslovaMKV: raises $0.04 to $0.06
pantelgr: folds 
kakah_sc: calls $0.05
OtB_PeruVian: raises $0.20 to $0.26
maslovaMKV: calls $0.20
kakah_sc: raises $0.51 to $0.77 and is all-in
OtB_PeruVian: raises $1.24 to $2.01 and is all-in
maslovaMKV: folds 
Uncalled bet ($1.24) returned to OtB_PeruVian
*** FLOP *** [2c 3c 9h]
*** TURN *** [2c 3c 9h] [9d]
*** RIVER *** [2c 3c 9h 9d] [7c]
*** SHOW DOWN ***
kakah_sc: shows [Ks 7s] (two pair, Nines and Sevens)
OtB_PeruVian: shows [Ac Kd] (a pair of Nines)
kakah_sc collected $1.74 from pot
*** SUMMARY ***
Total pot $1.80 | Rake $0.06 
Board [2c 3c 9h 9d 7c]
Seat 1: pedroabreu1 folded before Flop (didn't bet)
Seat 2: maslovaMKV folded before Flop
Seat 3: pantelgr (button) folded before Flop (didn't bet)
Seat 4: kakah_sc (small blind) showed [Ks 7s] and won ($1.74) with two pair, Nines and Sevens
Seat 5: OtB_PeruVian (big blind) showed [Ac Kd] and lost with a pair of Nines
Seat 6: ZOLOTO- XAXA folded before Flop (didn't bet)



PokerStars Hand #164797332029:  Hold'em No Limit ($0.01/$0.02 USD) - 2017/01/18 16:47:20 ET
Table 'Dollfus II' 6-max Seat #4 is the button
Seat 1: pedroabreu1 ($5.28 in chips) 
Seat 2: maslovaMKV ($1.50 in chips) 
Seat 3: pantelgr ($2.10 in chips) 
Seat 4: kakah_sc ($1.74 in chips) 
Seat 5: OtB_PeruVian ($2 in chips) 
OtB_PeruVian: posts small blind $0.01
ZOLOTO- XAXA: is sitting out 
pedroabreu1: posts big blind $0.02
*** HOLE CARDS ***
Dealt to pedroabreu1 [9s Ac]
maslovaMKV: calls $0.02
pantelgr: folds 
kakah_sc: calls $0.02
OtB_PeruVian: folds 
pedroabreu1: checks 
*** FLOP *** [2h 2s 8d]
pedroabreu1: checks 
maslovaMKV: checks 
kakah_sc: checks 
*** TURN *** [2h 2s 8d] [Tc]
pedroabreu1: checks 
maslovaMKV: checks 
kakah_sc: checks 
*** RIVER *** [2h 2s 8d Tc] [5h]
pedroabreu1: checks 
maslovaMKV: checks 
kakah_sc: checks 
*** SHOW DOWN ***
pedroabreu1: shows [9s Ac] (a pair of Deuces)
maslovaMKV: mucks hand 
kakah_sc: mucks hand 
pedroabreu1 collected $0.07 from pot
*** SUMMARY ***
Total pot $0.07 | Rake $0 
Board [2h 2s 8d Tc 5h]
Seat 1: pedroabreu1 (big blind) showed [9s Ac] and won ($0.07) with a pair of Deuces
Seat 2: maslovaMKV mucked [7s Qd]
Seat 3: pantelgr folded before Flop (didn't bet)
Seat 4: kakah_sc (button) mucked [Kh 7h]
Seat 5: OtB_PeruVian (small blind) folded before Flop



PokerStars Hand #164797385625:  Hold'em No Limit ($0.01/$0.02 USD) - 2017/01/18 16:48:14 ET
Table 'Dollfus II' 6-max Seat #5 is the button
Seat 1: pedroabreu1 ($5.33 in chips) 
Seat 2: maslovaMKV ($1.50 in chips) 
Seat 3: pantelgr ($2.10 in chips) 
Seat 4: kakah_sc ($1.72 in chips) 
Seat 5: OtB_PeruVian ($2 in chips) 
pedroabreu1: posts small blind $0.01
maslovaMKV: posts big blind $0.02
*** HOLE CARDS ***
Dealt to pedroabreu1 [Kc 2c]
pantelgr: folds 
kakah_sc: folds 
OtB_PeruVian: folds 
pedroabreu1: folds 
Uncalled bet ($0.01) returned to maslovaMKV
maslovaMKV collected $0.02 from pot
*** SUMMARY ***
Total pot $0.02 | Rake $0 
Seat 1: pedroabreu1 (small blind) folded before Flop
Seat 2: maslovaMKV (big blind) collected ($0.02)
Seat 3: pantelgr folded before Flop (didn't bet)
Seat 4: kakah_sc folded before Flop (didn't bet)
Seat 5: OtB_PeruVian (button) folded before Flop (didn't bet)



PokerStars Hand #164797397946:  Hold'em No Limit ($0.01/$0.02 USD) - 2017/01/18 16:48:26 ET
Table 'Dollfus II' 6-max Seat #1 is the button
Seat 1: pedroabreu1 ($5.32 in chips) 
Seat 2: maslovaMKV ($1.51 in chips) 
Seat 3: pantelgr ($2.10 in chips) 
Seat 4: kakah_sc ($1.72 in chips) 
Seat 5: OtB_PeruVian ($2 in chips) 
maslovaMKV: posts small blind $0.01
pantelgr: posts big blind $0.02
*** HOLE CARDS ***
Dealt to pedroabreu1 [4s 8h]
kakah_sc: calls $0.02
OtB_PeruVian has timed out
OtB_PeruVian: folds 
pedroabreu1: folds 
maslovaMKV: calls $0.01
pantelgr: checks 
*** FLOP *** [4c Kc 2h]
maslovaMKV: bets $0.02
pantelgr: folds 
kakah_sc: calls $0.02
*** TURN *** [4c Kc 2h] [5d]
maslovaMKV: checks 
kakah_sc: bets $0.06
maslovaMKV: folds 
Uncalled bet ($0.06) returned to kakah_sc
kakah_sc collected $0.10 from pot
kakah_sc: doesn't show hand 
*** SUMMARY ***
Total pot $0.10 | Rake $0 
Board [4c Kc 2h 5d]
Seat 1: pedroabreu1 (button) folded before Flop (didn't bet)
Seat 2: maslovaMKV (small blind) folded on the Turn
Seat 3: pantelgr (big blind) folded on the Flop
Seat 4: kakah_sc collected ($0.10)
Seat 5: OtB_PeruVian folded before Flop (didn't bet)



PokerStars Hand #164797458230:  Hold'em No Limit ($0.01/$0.02 USD) - 2017/01/18 16:49:25 ET
Table 'Dollfus II' 6-max Seat #2 is the button
Seat 1: pedroabreu1 ($5.32 in chips) 
Seat 2: maslovaMKV ($1.50 in chips) 
Seat 3: pantelgr ($2.08 in chips) 
Seat 4: kakah_sc ($1.78 in chips) 
Seat 5: OtB_PeruVian ($2 in chips) 
pantelgr: posts small blind $0.01
kakah_sc: posts big blind $0.02
*** HOLE CARDS ***
Dealt to pedroabreu1 [8d 7s]
OtB_PeruVian: raises $0.04 to $0.06
pedroabreu1: folds 
maslovaMKV: folds 
pantelgr: folds 
kakah_sc: folds 
Uncalled bet ($0.04) returned to OtB_PeruVian
OtB_PeruVian collected $0.05 from pot
OtB_PeruVian: doesn't show hand 
*** SUMMARY ***
Total pot $0.05 | Rake $0 
Seat 1: pedroabreu1 folded before Flop (didn't bet)
Seat 2: maslovaMKV (button) folded before Flop (didn't bet)
Seat 3: pantelgr (small blind) folded before Flop
Seat 4: kakah_sc (big blind) folded before Flop
Seat 5: OtB_PeruVian collected ($0.05)



PokerStars Hand #164797474650:  Hold'em No Limit ($0.01/$0.02 USD) - 2017/01/18 16:49:42 ET
Table 'Dollfus II' 6-max Seat #3 is the button
Seat 1: pedroabreu1 ($5.32 in chips) 
Seat 2: maslovaMKV ($1.50 in chips) 
Seat 3: pantelgr ($2.07 in chips) 
Seat 4: kakah_sc ($1.76 in chips) 
Seat 5: OtB_PeruVian ($2.03 in chips) 
kakah_sc: posts small blind $0.01
OtB_PeruVian: posts big blind $0.02
*** HOLE CARDS ***
Dealt to pedroabreu1 [7d 8c]
pedroabreu1: folds 
maslovaMKV: folds 
pantelgr: raises $0.03 to $0.05
kakah_sc: folds 
OtB_PeruVian: folds 
Uncalled bet ($0.03) returned to pantelgr
pantelgr collected $0.05 from pot
pantelgr: doesn't show hand 
*** SUMMARY ***
Total pot $0.05 | Rake $0 
Seat 1: pedroabreu1 folded before Flop (didn't bet)
Seat 2: maslovaMKV folded before Flop (didn't bet)
Seat 3: pantelgr (button) collected ($0.05)
Seat 4: kakah_sc (small blind) folded before Flop
Seat 5: OtB_PeruVian (big blind) folded before Flop



PokerStars Hand #164797506629:  Hold'em No Limit ($0.01/$0.02 USD) - 2017/01/18 16:50:09 ET
Table 'Dollfus II' 6-max Seat #4 is the button
Seat 1: pedroabreu1 ($5.32 in chips) 
Seat 2: maslovaMKV ($1.50 in chips) 
Seat 3: pantelgr ($2.10 in chips) 
Seat 4: kakah_sc ($1.75 in chips) 
Seat 5: OtB_PeruVian ($2.01 in chips) 
OtB_PeruVian: posts small blind $0.01
pedroabreu1: posts big blind $0.02
*** HOLE CARDS ***
Dealt to pedroabreu1 [Jd 5s]
maslovaMKV: folds 
pantelgr: folds 
kakah_sc: folds 
OtB_PeruVian: raises $0.04 to $0.06
pedroabreu1: folds 
Uncalled bet ($0.04) returned to OtB_PeruVian
OtB_PeruVian collected $0.04 from pot
OtB_PeruVian: doesn't show hand 
*** SUMMARY ***
Total pot $0.04 | Rake $0 
Seat 1: pedroabreu1 (big blind) folded before Flop
Seat 2: maslovaMKV folded before Flop (didn't bet)
Seat 3: pantelgr folded before Flop (didn't bet)
Seat 4: kakah_sc (button) folded before Flop (didn't bet)
Seat 5: OtB_PeruVian (small blind) collected ($0.04)



PokerStars Hand #164797520325:  Hold'em No Limit ($0.01/$0.02 USD) - 2017/01/18 16:50:23 ET
Table 'Dollfus II' 6-max Seat #5 is the button
Seat 1: pedroabreu1 ($5.30 in chips) 
Seat 2: maslovaMKV ($1.50 in chips) 
Seat 3: pantelgr ($2.10 in chips) 
Seat 4: kakah_sc ($1.75 in chips) 
Seat 5: OtB_PeruVian ($2.03 in chips) 
pedroabreu1: posts small blind $0.01
maslovaMKV: posts big blind $0.02
*** HOLE CARDS ***
Dealt to pedroabreu1 [8h 8d]
pantelgr: folds 
kakah_sc: calls $0.02
OtB_PeruVian: folds 
pedroabreu1: raises $0.06 to $0.08
maslovaMKV: folds 
kakah_sc: calls $0.06
*** FLOP *** [Kc Kd Qh]
pedroabreu1: bets $0.10
kakah_sc: calls $0.10
*** TURN *** [Kc Kd Qh] [3d]
pedroabreu1: checks 
kakah_sc: checks 
*** RIVER *** [Kc Kd Qh 3d] [Jh]
pedroabreu1: checks 
kakah_sc: checks 
*** SHOW DOWN ***
pedroabreu1: shows [8h 8d] (two pair, Kings and Eights)
kakah_sc: shows [8c Qc] (two pair, Kings and Queens)
kakah_sc collected $0.37 from pot
*** SUMMARY ***
Total pot $0.38 | Rake $0.01 
Board [Kc Kd Qh 3d Jh]
Seat 1: pedroabreu1 (small blind) showed [8h 8d] and lost with two pair, Kings and Eights
Seat 2: maslovaMKV (big blind) folded before Flop
Seat 3: pantelgr folded before Flop (didn't bet)
Seat 4: kakah_sc showed [8c Qc] and won ($0.37) with two pair, Kings and Queens
Seat 5: OtB_PeruVian (button) folded before Flop (didn't bet)



PokerStars Hand #164797556892:  Hold'em No Limit ($0.01/$0.02 USD) - 2017/01/18 16:51:00 ET
Table 'Dollfus II' 6-max Seat #1 is the button
Seat 1: pedroabreu1 ($5.12 in chips) 
Seat 2: maslovaMKV ($1.50 in chips) 
Seat 3: pantelgr ($2.10 in chips) 
Seat 4: kakah_sc ($1.94 in chips) 
Seat 5: OtB_PeruVian ($2.03 in chips) 
maslovaMKV: posts small blind $0.01
pantelgr: posts big blind $0.02
*** HOLE CARDS ***
Dealt to pedroabreu1 [Td Tc]
kakah_sc: folds 
OtB_PeruVian: folds 
pedroabreu1: raises $0.04 to $0.06
maslovaMKV: folds 
pantelgr: raises $0.18 to $0.24
pedroabreu1: calls $0.18
*** FLOP *** [Jh 5s Th]
pantelgr: bets $0.35
pedroabreu1: raises $0.65 to $1
pantelgr: raises $0.65 to $1.65
pedroabreu1: raises $0.65 to $2.30
pantelgr: calls $0.21 and is all-in
Uncalled bet ($0.44) returned to pedroabreu1
*** TURN *** [Jh 5s Th] [9s]
*** RIVER *** [Jh 5s Th 9s] [4s]
*** SHOW DOWN ***
pantelgr: shows [Kd Kc] (a pair of Kings)
pedroabreu1: shows [Td Tc] (three of a kind, Tens)
pedroabreu1 collected $4.06 from pot
*** SUMMARY ***
Total pot $4.21 | Rake $0.15 
Board [Jh 5s Th 9s 4s]
Seat 1: pedroabreu1 (button) showed [Td Tc] and won ($4.06) with three of a kind, Tens
Seat 2: maslovaMKV (small blind) folded before Flop
Seat 3: pantelgr (big blind) showed [Kd Kc] and lost with a pair of Kings
Seat 4: kakah_sc folded before Flop (didn't bet)
Seat 5: OtB_PeruVian folded before Flop (didn't bet)



PokerStars Hand #164797617496:  Hold'em No Limit ($0.01/$0.02 USD) - 2017/01/18 16:52:01 ET
Table 'Dollfus II' 6-max Seat #2 is the button
Seat 1: pedroabreu1 ($7.08 in chips) 
Seat 2: maslovaMKV ($1.50 in chips) 
Seat 3: pantelgr ($2 in chips) 
Seat 4: kakah_sc ($1.94 in chips) 
Seat 5: OtB_PeruVian ($2.03 in chips) 
pantelgr: posts small blind $0.01
kakah_sc: posts big blind $0.02
*** HOLE CARDS ***
Dealt to pedroabreu1 [As Kh]
OtB_PeruVian: folds 
pedroabreu1: raises $0.04 to $0.06
maslovaMKV: folds 
pantelgr: folds 
kakah_sc: folds 
Uncalled bet ($0.04) returned to pedroabreu1
pedroabreu1 collected $0.05 from pot
pedroabreu1: doesn't show hand 
*** SUMMARY ***
Total pot $0.05 | Rake $0 
Seat 1: pedroabreu1 collected ($0.05)
Seat 2: maslovaMKV (button) folded before Flop (didn't bet)
Seat 3: pantelgr (small blind) folded before Flop
Seat 4: kakah_sc (big blind) folded before Flop
Seat 5: OtB_PeruVian folded before Flop (didn't bet)



PokerStars Hand #164797631031:  Hold'em No Limit ($0.01/$0.02 USD) - 2017/01/18 16:52:15 ET
Table 'Dollfus II' 6-max Seat #3 is the button
Seat 1: pedroabreu1 ($7.11 in chips) 
Seat 2: maslovaMKV ($1.50 in chips) 
Seat 3: pantelgr ($2 in chips) 
Seat 4: kakah_sc ($1.92 in chips) 
Seat 5: OtB_PeruVian ($2.03 in chips) 
kakah_sc: posts small blind $0.01
OtB_PeruVian: posts big blind $0.02
*** HOLE CARDS ***
Dealt to pedroabreu1 [8s As]
pedroabreu1: raises $0.04 to $0.06
maslovaMKV: raises $0.15 to $0.21
pantelgr: folds 
kakah_sc: folds 
OtB_PeruVian: folds 
pedroabreu1: folds 
Uncalled bet ($0.15) returned to maslovaMKV
maslovaMKV collected $0.15 from pot
*** SUMMARY ***
Total pot $0.15 | Rake $0 
Seat 1: pedroabreu1 folded before Flop
Seat 2: maslovaMKV collected ($0.15)
Seat 3: pantelgr (button) folded before Flop (didn't bet)
Seat 4: kakah_sc (small blind) folded before Flop
Seat 5: OtB_PeruVian (big blind) folded before Flop



PokerStars Hand #164797657338:  Hold'em No Limit ($0.01/$0.02 USD) - 2017/01/18 16:52:42 ET
Table 'Dollfus II' 6-max Seat #4 is the button
Seat 1: pedroabreu1 ($7.05 in chips) 
Seat 2: maslovaMKV ($1.59 in chips) 
Seat 3: pantelgr ($2 in chips) 
Seat 4: kakah_sc ($1.91 in chips) 
Seat 5: OtB_PeruVian ($2.01 in chips) 
OtB_PeruVian: posts small blind $0.01
pedroabreu1: posts big blind $0.02
*** HOLE CARDS ***
Dealt to pedroabreu1 [Qd 8h]
maslovaMKV: folds 
pantelgr: folds 
kakah_sc: folds 
OtB_PeruVian: folds 
Uncalled bet ($0.01) returned to pedroabreu1
pedroabreu1 collected $0.02 from pot
pedroabreu1: doesn't show hand 
*** SUMMARY ***
Total pot $0.02 | Rake $0 
Seat 1: pedroabreu1 (big blind) collected ($0.02)
Seat 2: maslovaMKV folded before Flop (didn't bet)
Seat 3: pantelgr folded before Flop (didn't bet)
Seat 4: kakah_sc (button) folded before Flop (didn't bet)
Seat 5: OtB_PeruVian (small blind) folded before Flop



PokerStars Hand #164797671900:  Hold'em No Limit ($0.01/$0.02 USD) - 2017/01/18 16:52:56 ET
Table 'Dollfus II' 6-max Seat #5 is the button
Seat 1: pedroabreu1 ($7.06 in chips) 
Seat 2: maslovaMKV ($1.59 in chips) 
Seat 3: pantelgr ($2 in chips) 
Seat 4: kakah_sc ($1.91 in chips) 
Seat 5: OtB_PeruVian ($2 in chips) 
pedroabreu1: posts small blind $0.01
maslovaMKV: posts big blind $0.02
*** HOLE CARDS ***
Dealt to pedroabreu1 [Jd 6s]
pantelgr: folds 
kakah_sc: folds 
OtB_PeruVian: folds 
pedroabreu1: folds 
Uncalled bet ($0.01) returned to maslovaMKV
maslovaMKV collected $0.02 from pot
*** SUMMARY ***
Total pot $0.02 | Rake $0 
Seat 1: pedroabreu1 (small blind) folded before Flop
Seat 2: maslovaMKV (big blind) collected ($0.02)
Seat 3: pantelgr folded before Flop (didn't bet)
Seat 4: kakah_sc folded before Flop (didn't bet)
Seat 5: OtB_PeruVian (button) folded before Flop (didn't bet)



PokerStars Hand #164797683096:  Hold'em No Limit ($0.01/$0.02 USD) - 2017/01/18 16:53:07 ET
Table 'Dollfus II' 6-max Seat #1 is the button
Seat 1: pedroabreu1 ($7.05 in chips) 
Seat 2: maslovaMKV ($1.60 in chips) 
Seat 3: pantelgr ($2 in chips) 
Seat 4: kakah_sc ($1.91 in chips) 
Seat 5: OtB_PeruVian ($2 in chips) 
maslovaMKV: posts small blind $0.01
pantelgr: posts big blind $0.02
*** HOLE CARDS ***
Dealt to pedroabreu1 [5h 7d]
kakah_sc: calls $0.02
OtB_PeruVian: folds 
pedroabreu1: folds 
maslovaMKV: folds 
pantelgr: checks 
*** FLOP *** [3h Jc 9d]
pantelgr: checks 
kakah_sc: bets $0.04
pantelgr: calls $0.04
*** TURN *** [3h Jc 9d] [Jh]
pantelgr: checks 
kakah_sc: bets $0.06
pantelgr: calls $0.06
*** RIVER *** [3h Jc 9d Jh] [Ks]
pantelgr: checks 
kakah_sc: bets $0.10
pantelgr: calls $0.10
*** SHOW DOWN ***
kakah_sc: shows [Qc Qd] (two pair, Queens and Jacks)
pantelgr: mucks hand 
kakah_sc collected $0.43 from pot
*** SUMMARY ***
Total pot $0.45 | Rake $0.02 
Board [3h Jc 9d Jh Ks]
Seat 1: pedroabreu1 (button) folded before Flop (didn't bet)
Seat 2: maslovaMKV (small blind) folded before Flop
Seat 3: pantelgr (big blind) mucked [9h Ad]
Seat 4: kakah_sc showed [Qc Qd] and won ($0.43) with two pair, Queens and Jacks
Seat 5: OtB_PeruVian folded before Flop (didn't bet)



PokerStars Hand #164797737844:  Hold'em No Limit ($0.01/$0.02 USD) - 2017/01/18 16:54:05 ET
Table 'Dollfus II' 6-max Seat #2 is the button
Seat 1: pedroabreu1 ($7.05 in chips) 
Seat 2: maslovaMKV ($1.59 in chips) 
Seat 3: pantelgr ($2 in chips) 
Seat 4: kakah_sc ($2.12 in chips) 
Seat 5: OtB_PeruVian ($2 in chips) 
pantelgr: posts small blind $0.01
kakah_sc: posts big blind $0.02
*** HOLE CARDS ***
Dealt to pedroabreu1 [9d Jc]
OtB_PeruVian: folds 
pedroabreu1: folds 
maslovaMKV: folds 
pantelgr: folds 
Uncalled bet ($0.01) returned to kakah_sc
kakah_sc collected $0.02 from pot
kakah_sc: doesn't show hand 
*** SUMMARY ***
Total pot $0.02 | Rake $0 
Seat 1: pedroabreu1 folded before Flop (didn't bet)
Seat 2: maslovaMKV (button) folded before Flop (didn't bet)
Seat 3: pantelgr (small blind) folded before Flop
Seat 4: kakah_sc (big blind) collected ($0.02)
Seat 5: OtB_PeruVian folded before Flop (didn't bet)



PokerStars Hand #164797748790:  Hold'em No Limit ($0.01/$0.02 USD) - 2017/01/18 16:54:17 ET
Table 'Dollfus II' 6-max Seat #3 is the button
Seat 1: pedroabreu1 ($7.05 in chips) 
Seat 2: maslovaMKV ($1.59 in chips) 
Seat 3: pantelgr ($2 in chips) 
Seat 4: kakah_sc ($2.13 in chips) 
Seat 5: OtB_PeruVian ($2 in chips) 
kakah_sc: posts small blind $0.01
OtB_PeruVian: posts big blind $0.02
*** HOLE CARDS ***
Dealt to pedroabreu1 [Ah Jh]
pedroabreu1: raises $0.04 to $0.06
maslovaMKV: folds 
pantelgr: folds 
kakah_sc: folds 
OtB_PeruVian: folds 
Uncalled bet ($0.04) returned to pedroabreu1
pedroabreu1 collected $0.05 from pot
pedroabreu1: doesn't show hand 
*** SUMMARY ***
Total pot $0.05 | Rake $0 
Seat 1: pedroabreu1 collected ($0.05)
Seat 2: maslovaMKV folded before Flop (didn't bet)
Seat 3: pantelgr (button) folded before Flop (didn't bet)
Seat 4: kakah_sc (small blind) folded before Flop
Seat 5: OtB_PeruVian (big blind) folded before Flop



PokerStars Hand #164797769465:  Hold'em No Limit ($0.01/$0.02 USD) - 2017/01/18 16:54:39 ET
Table 'Dollfus II' 6-max Seat #4 is the button
Seat 1: pedroabreu1 ($7.08 in chips) 
Seat 2: maslovaMKV ($1.59 in chips) 
Seat 3: pantelgr ($2 in chips) 
Seat 4: kakah_sc ($2.12 in chips) 
Seat 5: OtB_PeruVian ($2 in chips) 
OtB_PeruVian: posts small blind $0.01
pedroabreu1: posts big blind $0.02
*** HOLE CARDS ***
Dealt to pedroabreu1 [4h 4d]
maslovaMKV: folds 
pantelgr: raises $0.04 to $0.06
kakah_sc: raises $0.04 to $0.10
OtB_PeruVian: folds 
pedroabreu1: calls $0.08
pantelgr: calls $0.04
*** FLOP *** [Js Jh 7s]
pedroabreu1: checks 
pantelgr: checks 
kakah_sc: bets $0.10
pedroabreu1: folds 
pantelgr: folds 
Uncalled bet ($0.10) returned to kakah_sc
kakah_sc collected $0.30 from pot
kakah_sc: doesn't show hand 
*** SUMMARY ***
Total pot $0.31 | Rake $0.01 
Board [Js Jh 7s]
Seat 1: pedroabreu1 (big blind) folded on the Flop
Seat 2: maslovaMKV folded before Flop (didn't bet)
Seat 3: pantelgr folded on the Flop
Seat 4: kakah_sc (button) collected ($0.30)
Seat 5: OtB_PeruVian (small blind) folded before Flop



PokerStars Hand #164797804842:  Hold'em No Limit ($0.01/$0.02 USD) - 2017/01/18 16:55:18 ET
Table 'Dollfus II' 6-max Seat #5 is the button
Seat 1: pedroabreu1 ($6.98 in chips) 
Seat 2: maslovaMKV ($1.59 in chips) 
Seat 3: pantelgr ($2 in chips) 
Seat 4: kakah_sc ($2.32 in chips) 
Seat 5: OtB_PeruVian ($2 in chips) 
pedroabreu1: posts small blind $0.01
maslovaMKV: posts big blind $0.02
*** HOLE CARDS ***
Dealt to pedroabreu1 [Ts As]
pantelgr: raises $0.04 to $0.06
kakah_sc: folds 
OtB_PeruVian: folds 
pedroabreu1: calls $0.05
maslovaMKV: folds 
*** FLOP *** [2h 7c 2d]
pedroabreu1: checks 
pantelgr: bets $0.09
pedroabreu1: calls $0.09
*** TURN *** [2h 7c 2d] [4h]
pedroabreu1: checks 
pantelgr: bets $0.21
pedroabreu1: folds 
Uncalled bet ($0.21) returned to pantelgr
pantelgr collected $0.31 from pot
pantelgr: doesn't show hand 
*** SUMMARY ***
Total pot $0.32 | Rake $0.01 
Board [2h 7c 2d 4h]
Seat 1: pedroabreu1 (small blind) folded on the Turn
Seat 2: maslovaMKV (big blind) folded before Flop
Seat 3: pantelgr collected ($0.31)
Seat 4: kakah_sc folded before Flop (didn't bet)
Seat 5: OtB_PeruVian (button) folded before Flop (didn't bet)



PokerStars Hand #164797840276:  Hold'em No Limit ($0.01/$0.02 USD) - 2017/01/18 16:56:05 ET
Table 'Dollfus II' 6-max Seat #1 is the button
Seat 1: pedroabreu1 ($6.83 in chips) 
Seat 2: maslovaMKV ($1.57 in chips) 
Seat 3: pantelgr ($2.16 in chips) 
Seat 4: kakah_sc ($2.32 in chips) 
Seat 5: OtB_PeruVian ($2 in chips) 
maslovaMKV: posts small blind $0.01
pantelgr: posts big blind $0.02
*** HOLE CARDS ***
Dealt to pedroabreu1 [6s 3h]
kakah_sc: folds 
OtB_PeruVian: folds 
pedroabreu1: folds 
maslovaMKV: raises $0.04 to $0.06
pantelgr: folds 
Uncalled bet ($0.04) returned to maslovaMKV
maslovaMKV collected $0.04 from pot
*** SUMMARY ***
Total pot $0.04 | Rake $0 
Seat 1: pedroabreu1 (button) folded before Flop (didn't bet)
Seat 2: maslovaMKV (small blind) collected ($0.04)
Seat 3: pantelgr (big blind) folded before Flop
Seat 4: kakah_sc folded before Flop (didn't bet)
Seat 5: OtB_PeruVian folded before Flop (didn't bet)



PokerStars Hand #164797856607:  Hold'em No Limit ($0.01/$0.02 USD) - 2017/01/18 16:56:26 ET
Table 'Dollfus II' 6-max Seat #2 is the button
Seat 1: pedroabreu1 ($6.83 in chips) 
Seat 2: maslovaMKV ($1.59 in chips) 
Seat 3: pantelgr ($2.14 in chips) 
Seat 4: kakah_sc ($2.32 in chips) 
Seat 5: OtB_PeruVian ($2 in chips) 
pantelgr: posts small blind $0.01
kakah_sc: posts big blind $0.02
*** HOLE CARDS ***
Dealt to pedroabreu1 [Td 6c]
OtB_PeruVian: folds 
pedroabreu1: folds 
maslovaMKV: folds 
pantelgr: raises $0.04 to $0.06
kakah_sc: calls $0.04
*** FLOP *** [2h Kh 2d]
pantelgr: bets $0.08
kakah_sc: folds 
Uncalled bet ($0.08) returned to pantelgr
pantelgr collected $0.12 from pot
pantelgr: doesn't show hand 
*** SUMMARY ***
Total pot $0.12 | Rake $0 
Board [2h Kh 2d]
Seat 1: pedroabreu1 folded before Flop (didn't bet)
Seat 2: maslovaMKV (button) folded before Flop (didn't bet)
Seat 3: pantelgr (small blind) collected ($0.12)
Seat 4: kakah_sc (big blind) folded on the Flop
Seat 5: OtB_PeruVian folded before Flop (didn't bet)



PokerStars Hand #164797883340:  Hold'em No Limit ($0.01/$0.02 USD) - 2017/01/18 16:57:01 ET
Table 'Dollfus II' 6-max Seat #3 is the button
Seat 1: pedroabreu1 ($6.83 in chips) 
Seat 2: maslovaMKV ($1.59 in chips) 
Seat 3: pantelgr ($2.20 in chips) 
Seat 4: kakah_sc ($2.26 in chips) 
Seat 5: OtB_PeruVian ($2 in chips) 
kakah_sc: posts small blind $0.01
OtB_PeruVian: posts big blind $0.02
*** HOLE CARDS ***
Dealt to pedroabreu1 [9d 8h]
pedroabreu1: folds 
maslovaMKV: folds 
pantelgr: raises $0.03 to $0.05
kakah_sc: calls $0.04
OtB_PeruVian: folds 
*** FLOP *** [9c 6h Qh]
kakah_sc: checks 
pantelgr: bets $0.08
kakah_sc: raises $0.08 to $0.16
pantelgr: folds 
Uncalled bet ($0.08) returned to kakah_sc
kakah_sc collected $0.27 from pot
kakah_sc: doesn't show hand 
*** SUMMARY ***
Total pot $0.28 | Rake $0.01 
Board [9c 6h Qh]
Seat 1: pedroabreu1 folded before Flop (didn't bet)
Seat 2: maslovaMKV folded before Flop (didn't bet)
Seat 3: pantelgr (button) folded on the Flop
Seat 4: kakah_sc (small blind) collected ($0.27)
Seat 5: OtB_PeruVian (big blind) folded before Flop



PokerStars Hand #164797913834:  Hold'em No Limit ($0.01/$0.02 USD) - 2017/01/18 16:57:40 ET
Table 'Dollfus II' 6-max Seat #4 is the button
Seat 1: pedroabreu1 ($6.83 in chips) 
Seat 2: maslovaMKV ($1.59 in chips) 
Seat 3: pantelgr ($2.07 in chips) 
Seat 4: kakah_sc ($2.40 in chips) 
Seat 5: OtB_PeruVian ($2 in chips) 
OtB_PeruVian: posts small blind $0.01
pedroabreu1: posts big blind $0.02
*** HOLE CARDS ***
Dealt to pedroabreu1 [4d Qc]
maslovaMKV: folds 
pantelgr: folds 
kakah_sc: calls $0.02
OtB_PeruVian: folds 
pedroabreu1: checks 
*** FLOP *** [3h 6d 9s]
pedroabreu1: checks 
kakah_sc: checks 
*** TURN *** [3h 6d 9s] [4h]
pedroabreu1: checks 
kakah_sc: checks 
*** RIVER *** [3h 6d 9s 4h] [7d]
pedroabreu1: checks 
kakah_sc: checks 
*** SHOW DOWN ***
pedroabreu1: shows [4d Qc] (a pair of Fours)
kakah_sc: mucks hand 
pedroabreu1 collected $0.05 from pot
*** SUMMARY ***
Total pot $0.05 | Rake $0 
Board [3h 6d 9s 4h 7d]
Seat 1: pedroabreu1 (big blind) showed [4d Qc] and won ($0.05) with a pair of Fours
Seat 2: maslovaMKV folded before Flop (didn't bet)
Seat 3: pantelgr folded before Flop (didn't bet)
Seat 4: kakah_sc (button) mucked [Ac Kd]
Seat 5: OtB_PeruVian (small blind) folded before Flop



PokerStars Hand #164797935931:  Hold'em No Limit ($0.01/$0.02 USD) - 2017/01/18 16:58:09 ET
Table 'Dollfus II' 6-max Seat #5 is the button
Seat 1: pedroabreu1 ($6.86 in chips) 
Seat 2: maslovaMKV ($1.59 in chips) 
Seat 3: pantelgr ($2.07 in chips) 
Seat 4: kakah_sc ($2.38 in chips) 
Seat 5: OtB_PeruVian ($2 in chips) 
pedroabreu1: posts small blind $0.01
maslovaMKV: posts big blind $0.02
*** HOLE CARDS ***
Dealt to pedroabreu1 [3c 7d]
pantelgr: folds 
kakah_sc: calls $0.02
OtB_PeruVian: folds 
pedroabreu1: folds 
maslovaMKV: checks 
*** FLOP *** [9h Kc Kh]
maslovaMKV: bets $0.02
kakah_sc: calls $0.02
*** TURN *** [9h Kc Kh] [Qd]
maslovaMKV: bets $0.09
kakah_sc: raises $0.09 to $0.18
maslovaMKV: calls $0.09
*** RIVER *** [9h Kc Kh Qd] [Qc]
maslovaMKV: bets $0.43
kakah_sc: calls $0.43
*** SHOW DOWN ***
maslovaMKV: shows [5h Ks] (a full house, Kings full of Queens)
kakah_sc: mucks hand 
maslovaMKV collected $1.26 from pot
*** SUMMARY ***
Total pot $1.31 | Rake $0.05 
Board [9h Kc Kh Qd Qc]
Seat 1: pedroabreu1 (small blind) folded before Flop
Seat 2: maslovaMKV (big blind) showed [5h Ks] and won ($1.26) with a full house, Kings full of Queens
Seat 3: pantelgr folded before Flop (didn't bet)
Seat 4: kakah_sc mucked [Th Jh]
Seat 5: OtB_PeruVian (button) folded before Flop (didn't bet)



PokerStars Hand #164797968382:  Hold'em No Limit ($0.01/$0.02 USD) - 2017/01/18 16:58:51 ET
Table 'Dollfus II' 6-max Seat #1 is the button
Seat 1: pedroabreu1 ($6.85 in chips) 
Seat 2: maslovaMKV ($2.20 in chips) 
Seat 3: pantelgr ($2.07 in chips) 
Seat 4: kakah_sc ($1.73 in chips) 
Seat 5: OtB_PeruVian ($2 in chips) 
maslovaMKV: posts small blind $0.01
pantelgr: posts big blind $0.02
*** HOLE CARDS ***
Dealt to pedroabreu1 [2h 4s]
kakah_sc: calls $0.02
OtB_PeruVian: folds 
pedroabreu1: folds 
maslovaMKV: calls $0.01
pantelgr: checks 
*** FLOP *** [Ks 3h Qc]
maslovaMKV: checks 
pantelgr: checks 
kakah_sc: bets $0.02
maslovaMKV: folds 
pantelgr: folds 
Uncalled bet ($0.02) returned to kakah_sc
kakah_sc collected $0.06 from pot
kakah_sc: doesn't show hand 
*** SUMMARY ***
Total pot $0.06 | Rake $0 
Board [Ks 3h Qc]
Seat 1: pedroabreu1 (button) folded before Flop (didn't bet)
Seat 2: maslovaMKV (small blind) folded on the Flop
Seat 3: pantelgr (big blind) folded on the Flop
Seat 4: kakah_sc collected ($0.06)
Seat 5: OtB_PeruVian folded before Flop (didn't bet)



PokerStars Hand #164797991923:  Hold'em No Limit ($0.01/$0.02 USD) - 2017/01/18 16:59:22 ET
Table 'Dollfus II' 6-max Seat #2 is the button
Seat 1: pedroabreu1 ($6.85 in chips) 
Seat 2: maslovaMKV ($2.18 in chips) 
Seat 3: pantelgr ($2.05 in chips) 
Seat 4: kakah_sc ($1.77 in chips) 
Seat 5: OtB_PeruVian ($2 in chips) 
pantelgr: posts small blind $0.01
kakah_sc: posts big blind $0.02
*** HOLE CARDS ***
Dealt to pedroabreu1 [5s 7c]
OtB_PeruVian: folds 
pedroabreu1: folds 
maslovaMKV: folds 
pantelgr: folds 
Uncalled bet ($0.01) returned to kakah_sc
kakah_sc collected $0.02 from pot
kakah_sc: doesn't show hand 
*** SUMMARY ***
Total pot $0.02 | Rake $0 
Seat 1: pedroabreu1 folded before Flop (didn't bet)
Seat 2: maslovaMKV (button) folded before Flop (didn't bet)
Seat 3: pantelgr (small blind) folded before Flop
Seat 4: kakah_sc (big blind) collected ($0.02)
Seat 5: OtB_PeruVian folded before Flop (didn't bet)



PokerStars Hand #164798002434:  Hold'em No Limit ($0.01/$0.02 USD) - 2017/01/18 16:59:35 ET
Table 'Dollfus II' 6-max Seat #3 is the button
Seat 1: pedroabreu1 ($6.85 in chips) 
Seat 2: maslovaMKV ($2.18 in chips) 
Seat 3: pantelgr ($2.04 in chips) 
Seat 4: kakah_sc ($1.78 in chips) 
Seat 5: OtB_PeruVian ($2 in chips) 
kakah_sc: posts small blind $0.01
OtB_PeruVian: posts big blind $0.02
*** HOLE CARDS ***
Dealt to pedroabreu1 [Kh 7c]
pedroabreu1: folds 
maslovaMKV: calls $0.02
pantelgr: folds 
kakah_sc: calls $0.01
OtB_PeruVian: checks 
*** FLOP *** [5c 8h Th]
kakah_sc: checks 
OtB_PeruVian: checks 
maslovaMKV: checks 
*** TURN *** [5c 8h Th] [6c]
kakah_sc: checks 
OtB_PeruVian: checks 
maslovaMKV: checks 
*** RIVER *** [5c 8h Th 6c] [8s]
kakah_sc: checks 
OtB_PeruVian: checks 
maslovaMKV: checks 
*** SHOW DOWN ***
kakah_sc: shows [4d Jd] (a pair of Eights)
OtB_PeruVian: shows [9s Jc] (a pair of Eights - Jack+Ten+Nine kicker)
maslovaMKV: shows [Qh Kc] (a pair of Eights - King kicker)
maslovaMKV collected $0.06 from pot
*** SUMMARY ***
Total pot $0.06 | Rake $0 
Board [5c 8h Th 6c 8s]
Seat 1: pedroabreu1 folded before Flop (didn't bet)
Seat 2: maslovaMKV showed [Qh Kc] and won ($0.06) with a pair of Eights
Seat 3: pantelgr (button) folded before Flop (didn't bet)
Seat 4: kakah_sc (small blind) showed [4d Jd] and lost with a pair of Eights
Seat 5: OtB_PeruVian (big blind) showed [9s Jc] and lost with a pair of Eights



PokerStars Hand #164798034900:  Hold'em No Limit ($0.01/$0.02 USD) - 2017/01/18 17:00:17 ET
Table 'Dollfus II' 6-max Seat #4 is the button
Seat 1: pedroabreu1 ($6.85 in chips) 
Seat 2: maslovaMKV ($2.22 in chips) 
Seat 3: pantelgr ($2.04 in chips) 
Seat 4: kakah_sc ($1.76 in chips) 
Seat 5: OtB_PeruVian ($2 in chips) 
OtB_PeruVian: posts small blind $0.01
ZOLOTO- XAXA was removed from the table for failing to post
pedroabreu1: posts big blind $0.02
*** HOLE CARDS ***
Dealt to pedroabreu1 [Kc Qh]
maslovaMKV: folds 
pantelgr: folds 
kakah_sc: calls $0.02
OtB_PeruVian: folds 
Xenon934 joins the table at seat #6 
pedroabreu1: raises $0.08 to $0.10
kakah_sc: calls $0.08
*** FLOP *** [8c Qd Qs]
pedroabreu1: bets $0.12
kakah_sc: calls $0.12
*** TURN *** [8c Qd Qs] [6h]
pedroabreu1: bets $0.26
kakah_sc: calls $0.26
*** RIVER *** [8c Qd Qs 6h] [2c]
pedroabreu1: bets $0.50
kakah_sc: calls $0.50
*** SHOW DOWN ***
pedroabreu1: shows [Kc Qh] (three of a kind, Queens)
kakah_sc: mucks hand 
pedroabreu1 collected $1.90 from pot
*** SUMMARY ***
Total pot $1.97 | Rake $0.07 
Board [8c Qd Qs 6h 2c]
Seat 1: pedroabreu1 (big blind) showed [Kc Qh] and won ($1.90) with three of a kind, Queens
Seat 2: maslovaMKV folded before Flop (didn't bet)
Seat 3: pantelgr folded before Flop (didn't bet)
Seat 4: kakah_sc (button) mucked [Tc Td]
Seat 5: OtB_PeruVian (small blind) folded before Flop



PokerStars Hand #164798091243:  Hold'em No Limit ($0.01/$0.02 USD) - 2017/01/18 17:01:24 ET
Table 'Dollfus II' 6-max Seat #5 is the button
Seat 1: pedroabreu1 ($7.77 in chips) 
Seat 2: maslovaMKV ($2.22 in chips) 
Seat 3: pantelgr ($2.04 in chips) 
Seat 4: kakah_sc ($0.78 in chips) 
Seat 5: OtB_PeruVian ($2 in chips) 
Xenon934 will be allowed to play after the button
pedroabreu1: posts small blind $0.01
maslovaMKV: posts big blind $0.02
*** HOLE CARDS ***
Dealt to pedroabreu1 [9d 2s]
pantelgr: folds 
kakah_sc: folds 
kakah_sc leaves the table
OtB_PeruVian: folds 
pedroabreu1: folds 
Uncalled bet ($0.01) returned to maslovaMKV
maslovaMKV collected $0.02 from pot
*** SUMMARY ***
Total pot $0.02 | Rake $0 
Seat 1: pedroabreu1 (small blind) folded before Flop
Seat 2: maslovaMKV (big blind) collected ($0.02)
Seat 3: pantelgr folded before Flop (didn't bet)
Seat 4: kakah_sc folded before Flop (didn't bet)
Seat 5: OtB_PeruVian (button) folded before Flop (didn't bet)



PokerStars Hand #164798101041:  Hold'em No Limit ($0.01/$0.02 USD) - 2017/01/18 17:01:35 ET
Table 'Dollfus II' 6-max Seat #1 is the button
Seat 1: pedroabreu1 ($7.76 in chips) 
Seat 2: maslovaMKV ($2.23 in chips) 
Seat 3: pantelgr ($2.04 in chips) 
Seat 5: OtB_PeruVian ($2 in chips) 
maslovaMKV: posts small blind $0.01
ZOLOTO- XAXA joins the table at seat #4 
pantelgr: posts big blind $0.02
Xenon934: sits out 
*** HOLE CARDS ***
Dealt to pedroabreu1 [9s 2d]
OtB_PeruVian: raises $0.04 to $0.06
pedroabreu1: folds 
maslovaMKV: folds 
pantelgr: folds 
Uncalled bet ($0.04) returned to OtB_PeruVian
OtB_PeruVian collected $0.05 from pot
OtB_PeruVian: doesn't show hand 
*** SUMMARY ***
Total pot $0.05 | Rake $0 
Seat 1: pedroabreu1 (button) folded before Flop (didn't bet)
Seat 2: maslovaMKV (small blind) folded before Flop
Seat 3: pantelgr (big blind) folded before Flop
Seat 5: OtB_PeruVian collected ($0.05)



PokerStars Hand #164798114168:  Hold'em No Limit ($0.01/$0.02 USD) - 2017/01/18 17:01:50 ET
Table 'Dollfus II' 6-max Seat #2 is the button
Seat 1: pedroabreu1 ($7.76 in chips) 
Seat 2: maslovaMKV ($2.22 in chips) 
Seat 3: pantelgr ($2.02 in chips) 
Seat 4: ZOLOTO- XAXA ($2 in chips) 
Seat 5: OtB_PeruVian ($2.03 in chips) 
pantelgr: posts small blind $0.01
ZOLOTO- XAXA: posts big blind $0.02
Xenon934: sits out 
*** HOLE CARDS ***
Dealt to pedroabreu1 [6d 5s]
OtB_PeruVian: folds 
pedroabreu1: folds 
maslovaMKV: folds 
pantelgr: folds 
Uncalled bet ($0.01) returned to ZOLOTO- XAXA
ZOLOTO- XAXA collected $0.02 from pot
ZOLOTO- XAXA: doesn't show hand 
*** SUMMARY ***
Total pot $0.02 | Rake $0 
Seat 1: pedroabreu1 folded before Flop (didn't bet)
Seat 2: maslovaMKV (button) folded before Flop (didn't bet)
Seat 3: pantelgr (small blind) folded before Flop
Seat 4: ZOLOTO- XAXA (big blind) collected ($0.02)
Seat 5: OtB_PeruVian folded before Flop (didn't bet)



PokerStars Hand #164798123869:  Hold'em No Limit ($0.01/$0.02 USD) - 2017/01/18 17:02:00 ET
Table 'Dollfus II' 6-max Seat #3 is the button
Seat 1: pedroabreu1 ($7.76 in chips) 
Seat 2: maslovaMKV ($2.22 in chips) 
Seat 3: pantelgr ($2.01 in chips) 
Seat 4: ZOLOTO- XAXA ($2.01 in chips) 
Seat 5: OtB_PeruVian ($2.03 in chips) 
ZOLOTO- XAXA: posts small blind $0.01
OtB_PeruVian: posts big blind $0.02
Xenon934: sits out 
*** HOLE CARDS ***
Dealt to pedroabreu1 [Kd Td]
pedroabreu1: raises $0.04 to $0.06
maslovaMKV: folds 
pantelgr: folds 
ZOLOTO- XAXA: folds 
maslovaMKV leaves the table
OtB_PeruVian: raises $0.14 to $0.20
pedroabreu1: calls $0.14
*** FLOP *** [7h 7d 9h]
OtB_PeruVian: bets $0.19
pedroabreu1: calls $0.19
*** TURN *** [7h 7d 9h] [3d]
OtB_PeruVian: checks 
pedroabreu1: checks 
*** RIVER *** [7h 7d 9h 3d] [7c]
OtB_PeruVian: checks 
pedroabreu1: checks 
*** SHOW DOWN ***
OtB_PeruVian: shows [Kh As] (three of a kind, Sevens)
pedroabreu1: mucks hand 
OtB_PeruVian collected $0.76 from pot
*** SUMMARY ***
Total pot $0.79 | Rake $0.03 
Board [7h 7d 9h 3d 7c]
Seat 1: pedroabreu1 mucked [Kd Td]
Seat 2: maslovaMKV folded before Flop (didn't bet)
Seat 3: pantelgr (button) folded before Flop (didn't bet)
Seat 4: ZOLOTO- XAXA (small blind) folded before Flop
Seat 5: OtB_PeruVian (big blind) showed [Kh As] and won ($0.76) with three of a kind, Sevens



PokerStars Hand #164798167833:  Hold'em No Limit ($0.01/$0.02 USD) - 2017/01/18 17:02:47 ET
Table 'Dollfus II' 6-max Seat #4 is the button
Seat 1: pedroabreu1 ($7.37 in chips) 
Seat 3: pantelgr ($2.01 in chips) 
Seat 4: ZOLOTO- XAXA ($2 in chips) 
Seat 5: OtB_PeruVian ($2.40 in chips) 
Seat 6: Xenon934 ($2 in chips) 
OtB_PeruVian: posts small blind $0.01
Xenon934: posts big blind $0.02
*** HOLE CARDS ***
Dealt to pedroabreu1 [9d 6d]
pedroabreu1: folds 
pantelgr: folds 
ZOLOTO- XAXA: folds 
Felinolog joins the table at seat #2 
OtB_PeruVian: folds 
Uncalled bet ($0.01) returned to Xenon934
Xenon934 collected $0.02 from pot
Xenon934: doesn't show hand 
*** SUMMARY ***
Total pot $0.02 | Rake $0 
Seat 1: pedroabreu1 folded before Flop (didn't bet)
Seat 3: pantelgr folded before Flop (didn't bet)
Seat 4: ZOLOTO- XAXA (button) folded before Flop (didn't bet)
Seat 5: OtB_PeruVian (small blind) folded before Flop
Seat 6: Xenon934 (big blind) collected ($0.02)



